OLGA       : MILLIE     
ROB        : LANA       GATES      ALISSA     WHITE      BLAKE      HAYDEN     
DORIS      : GONZALES   MILO       
WILLARD    : KELLEY     CLARENCE   TYREE      BRUCE      FERRELL    
COLON      : BRIAN      DAPHNE     BRADFORD   TUCKER     MORROW     RICK       
MAVIS      : CARDENAS   TABITHA    CONSUELO   
LANDON     : JOYNER     RICK       
KATHERINE  : MAXWELL    DENA       
PAGE       : RODGERS    VALENCIA   
HOOPER     : HORN       SHERMAN    
OLIVER     : CONNER     BRUNO      MARGARITA  HEATH      LAWANDA    
CASTILLO   : KATHLEEN   ENGLISH    LEVI       NUNEZ      
TRENTON    : JIMMIE     ESMERALDA  ORR        FAULKNER   
RAMSEY     : RONALD     DIXON      GILMORE    RICARDO    OBRIEN     
VILMA      : BENJAMIN   VANCE      KNIGHT     BARNES     CHAVEZ     
MCDONALD   : LILIANA    LYDIA      BARRERA    HUMBERTO   
PEARSON    : CORNELIUS  RICHARD    
WALTON     : HAROLD     OBRIEN     
CARLSON    : JULIA      ERNESTINE  KIP        WYATT      SONYA      
MARISOL    : CLARK      CHRISTA    SCOTTIE    
LESTER     : SOLIS      EVE        HARDY      BRADSHAW   KEITH      
MANN       : MCNEIL     DONNA      CHRISTI    
PERRY      : DORA       CORRINE    SUZETTE    GLORIA     BLAIR      STEPHENSON DANA       
KATY       : ADELINE    CORRINE    BILLIE     
MARK       : STEELE     MARYANNE   SYKES      MADELINE   
ANTONE     : CONCEPCION FRANKIE    MARVIN     RUSSELL    ROYCE      
JOHN       : TAMERA     HOUSTON    DONA       WOODWARD   HUMBERTO   PATSY      
MAXWELL    : KATHERINE  BLAKE      
ANNA       : JAMEL      NICHOLSON  CARLA      PARKS      
LETITIA    : PATE       ADAM       WILLIS     CASEY      
VALERIE    : KOCH       STRONG     POLLARD    FOWLER     
MCKAY      : TIMMY      FLEMING    ESTEBAN    CORTEZ     CLEMONS    
PRINCE     : WARD       EMILY      MCCALL     
LUCIEN     : BOBBIE     SUAREZ     MONA       MCKEE      
CHANEY     : DYLAN      STACIE     WALL       JEWELL     CONSTANCE  
GILMORE    : RAMSEY     KLINE      LOGAN      MALLORY    HOFFMAN    BARTON     
LESLIE     : TORRES     OMAR       RANDOLPH   
MARION     : LEE        ED         RORY       SIMONE     RICHARDSON 
GLENN      : SOLIS      WHITE      RODRIGUEZ  NIEVES     
LEE        : MARION     HERMAN     CASE       HEBERT     SUAREZ     RUSSO      
HATFIELD   : LEVI       WILLIS     CROSBY     HILL       
CRYSTAL    : POTTS      HEIDI      TATE       VARGAS     GEORGIA    
LUCILLE    : HOLT       PAT        NOEMI      DELACRUZ   GENEVA     
PATE       : LETITIA    EVANGELINE 
MONICA     : HEATH      DEMETRIUS  
LENARD     : LUCIANO    VALENZUELA KENNEDY    AURORA     LEANN      
RAMIRO     : DIONNE     OLA        TONI       LILIANA    LILA       THURMAN    BLAIR      
PHOEBE     : FORBES     BARKER     HEAD       RICHARD    BOBBIE     MARGERY    TERENCE    ONEIL      
PHOEBE     : 
FOX        : AUBREY     TERENCE    
ROBERTA    : HOLLOWAY   JOHNS      SHEPHERD   
BENJAMIN   : VILMA      VERA       SANTIAGO   INGRAM     
LEONOR     : JIM        BRIAN      SNOW       
TILLMAN    : AVIS       AHMED      
AVIS       : TILLMAN    MYERS      LORNA      PASQUALE   
ANDERSON   : AISHA      GOLDIE     MABEL      HODGE      
JENNINGS   : RUTLEDGE   HUNT       LINDSEY    
LATONYA    : CONLEY     MILES      ERMA       ANDREA     MARSHALL   
ODESSA     : BRANDY     
LILIANA    : MCDONALD   RAMIRO     NOLAN      GOOD       
LITTLE     : RIVERA     BOYD       ANDREWS    SIDNEY     FAULKNER   JEANNE     
MADELINE   : MARK       MCLAUGHLIN TAYLOR     DONA       PETERSEN   
PERCY      : DURAN      KARYN      
WARD       : PRINCE     DILLON     SCHNEIDER  
KNOX       : BETHANY    COLLEEN    WASHINGTON MCCARTHY   FIGUEROA   ERMA       
FIELDS     : GUY        DAPHNE     DOROTHEA   ELDON      BRADFORD   
AMIE       : SYDNEY     GREGORY    MARTHA     LAUREL     
WITT       : BOBBI      CARMINE    
CANDICE    : IVANA      BUDDY      PARK       ANDREW     
MONTGOMERY : FERRELL    SEARS      EVANGELINA 
JANELLE    : ROSALIE    NANNIE     SILAS      SARA       CATHRYN    
HOLDEN     : YOUNG      COX        MONA       CAMACHO    JULIET     
DERICK     : MOLINA     ERNESTINE  CASANDRA   ROBLES     
MEREDITH   : MILLICENT  QUINTON    KELLER     
WALTERS    : GUTHRIE    
ABE        : SOTO       DEMETRIUS  CHARMAINE  MCCULLOUGH 
JACKIE     : PATSY      LEMUEL     
COPELAND   : EDITH      LARSON     ERNA       STEVEN     HURST      KERR       
ESTES      : GENARO     HENDRICKS  RUSSEL     GERARDO    
HERRERA    : ART        MELBA      ROBBINS    ROCKY      MOODY      RACHAEL    
THELMA     : NICOLAS    
MILAGROS   : SLOAN      HOFFMAN    HUNT       SELENA     NADINE     ALBERT     
ARIEL      : KNOWLES    HUNTER     SIDNEY     DARRYL     
MERCADO    : JAIME      CARLENE    
MCNEIL     : MANN       KRAMER     ENID       
SIMON      : ANGELITA   
TODD       : GRIMES     EMILE      FERRELL    AGNES      CARROLL    
MARCELINO  : LEWIS      STEVENSON  GARRETT    
WILCOX     : TATE       
LEACH      : ABRAHAM    KERR       STEELE     CANTU      
IRIS       : JACOB      EMILY      MONROE     LIDIA      
INES       : LORENZO    MAXINE     REEVES     YOUNG      YVETTE     
WEBSTER    : CLINT      
RAMOS      : POPE       MICHEAL    
BLACKWELL  : DARCY      NEIL       SARGENT    LINDSEY    
ANIBAL     : WISE       KRAMER     PETER      HICKS      
DONOVAN    : PHILLIPS   NAPOLEON   HEAD       PATRICK    GALLAGHER  
LILA       : RAMIRO     JUAREZ     
HOBBS      : BROCK      ART        NITA       RASMUSSEN  
STACIE     : CHANEY     CINDY      FRANKLIN   
CHRISTI    : MANN       REFUGIO    EARNEST    MACK       
LOIS       : BOOTH      
JAMAAL     : TAMMY      IRA        
BALDWIN    : SERGIO     ROSS       MARIANA    MERLIN     CASSIE     
MONTY      : MERRITT    BRYON      BRIAN      BEST       PEREZ      
HARRINGTON : DIONNE     HART       KRISTINA   PAM        
PICKETT    : ANTONIA    CARDENAS   RENA       COOKE      WILL       
EUGENIA    : DELGADO    SANCHEZ    CLEMONS    
SAM        : CAITLIN    WHITAKER   
OCTAVIO    : MARIANA    WARREN     
HAMILTON   : KLINE      FIGUEROA   NIEVES     KEVEN      LORI       ROSARIO    DIXIE      PARKS      
HAMILTON   : 
CRISTINA   : WENDI      VERNON     
BRENDAN    : CLAUDETTE  PRISCILLA  FUENTES    MAXINE     BERNADINE  
BARRY      : GERARDO    JARROD     SCOTTIE    FERN       BUCKLEY    DICK       
WARREN     : OCTAVIO    BRENTON    COTE       NICOLAS    GILLESPIE  HUMBERTO   LACEY      
HANNAH     : WHITFIELD  DEENA      EFREN      
ERIN       : MARISSA    CARR       
HOUSTON    : JOHN       ANDREWS    VALENCIA   JOHNSON    
BELL       : DENA       ERNIE      WINFRED    VICKY      KRISTINA   
SWEET      : MARGARITA  NAPOLEON   RONNY      PAM        JAMAR      MOISES     
BARLOW     : DOMINGO    LELIA      OMAR       MOODY      ARTHUR     CUMMINGS   
DUNN       : STEWART    KENTON     CUNNINGHAM AUBREY     ALYSON     
LANA       : ROB        HUGHES     BOYLE      SANTIAGO   ROBT       DAMIAN     
YANG       : HUFFMAN    TRENT      DANIAL     
ANDY       : DILLON     REGGIE     MURIEL     CLAUDIA    
HIRAM      : HAROLD     GREENE     
CONNIE     : RICHARD    KNIGHT     ROBERTSON  PHILLIPS   
BARNES     : VILMA      LYDIA      ROBIN      
JEFFERSON  : KELLER     
PAMELA     : RODNEY     WALLER     DINO       
MERCEDES   : JUANITA    VALENCIA   ANTONIO    BURKS      
HORTON     : BEAN       JANINE     ORTIZ      PARRISH    
HERBERT    : FAITH      
BARRERA    : MCDONALD   WILLIAMS   NOE        MILDRED    
MCCONNELL  : VERNON     HALL       GRIFFIN    BRIGHT     EARL       LEROY      
ROSALIE    : JANELLE    TASHA      AYALA      WINTERS    EDMUND     
CHARLOTTE  : JIMENEZ    CARROLL    CLAUDIA    
JILL       : MCCARTY    SHIRLEY    ELINOR     
MAC        : KNOWLES    KIP        SOSA       
WALDO      : CAMERON    LON        HUNT       
LEVI       : HATFIELD   CASTILLO   BAKER      LORNA      
WARNER     : AHMED      KNOWLES    DENA       GINGER     HOWARD     
HARRELL    : DONNY      GONZALES   STACY      COOLEY     HORN       PACHECO    JESSE      MCCORMICK  
HARRELL    : STRONG     
GOMEZ      : FINLEY     RAYMOND    
SOTO       : ABE        BREWER     TORRES     RICK       LANCASTER  
ABRAHAM    : LEACH      ERNA       IAN        
JIMENEZ    : CHARLOTTE  COX        RICKY      BLANCHARD  
ALLISON    : BERTIE     STEVENSON  EDITH      BONITA     SALVATORE  
BUCKNER    : LUCAS      BLAIR      MCKENZIE   TRUDY      MACK       
FREDERIC   : MCCLURE    
COMBS      : ROSETTA    GONZALEZ   
DODSON     : PITTMAN    LLOYD      STRICKLAND 
REBEKAH    : CARISSA    VANCE      NOEL       
ROSETTA    : COMBS      DAWN       MATTHEWS   AYALA      
HARDY      : LESTER     MAGGIE     
VELASQUEZ  : FLEMING    CHANG      WHITAKER   MORRIS     FREDRIC    
WEBER      : AYERS      ISABELLE   LUCIANO    TREY       
BAIRD      : THOMAS     SAMUEL     CHARMAINE  
ALEXANDER  : SANTANA    EMILE      PAYNE      ROSALES    
BRYON      : MONTY      MARGARITA  SETH       CUNNINGHAM EVERETT    
MARGARITA  : SWEET      BRYON      OLIVER     BRENTON    ELLIOTT    GOODWIN    
OCONNOR    : PITTS      HULL       MOSLEY     
ALVIN      : GRIMES     VASQUEZ    BOWMAN     BURKS      
FOREST     : PUGH       JOHNSTON   ZAMORA     TOMMY      JUAREZ     RUSS       
CHARITY    : ALTA       LARSON     LINDSAY    DON        
COOKE      : PICKETT    DON        SANTIAGO   MEADOWS    
DIONNE     : RAMIRO     HARRINGTON KENDALL    TREVINO    WALLS      ANTONIO    
TRICIA     : AURELIA    BRUCE      ROSALINDA  WALL       GRAY       TONI       
VERA       : BENJAMIN   DARRYL     GILLESPIE  BRIDGET    
NUNEZ      : CASTILLO   REYES      SHERYL     CHRISTINE  BETH       
ALBA       : PACHECO    
ISSAC      : NORMA      BUCHANAN   
FLOSSIE    : WILLIAMS   AURELIA    
ELMA       : BAKER      JEANNE     ANGIE      ISIAH      
BLEVINS    : MARGERY    WEAVER     
BUCK       : BERNADETTE JOHNSTON   
NICOLE     : JASPER     
MCMILLAN   : BOBBI      LAWSON     LOTT       CARVER     
REEVES     : INES       NEAL       GALLOWAY   EVANGELINE 
BYRD       : JARVIS     HARPER     AVERY      
MOSES      : TAYLOR     GOLDIE     DONNY      RUSS       HARRISON   
IRWIN      : MCKENZIE   NEWMAN     PHILIP     MARIE      
CAITLIN    : SAM        FRANCES    TARA       COOK       SYBIL      
STEPHENS   : AMANDA     BONNER     ERNA       
SYDNEY     : AMIE       OBRIEN     RICO       LORNA      
DINO       : PAMELA     MCCULLOUGH 
CLEMENTS   : DEANA      FRANCISCO  DANIELS    CHRISTIAN  GAY        DEAN       
MCCARTHY   : KNOX       DEWAYNE    THURMAN    
OSCAR      : MARY       AYALA      HOLLAND    WALSH      LIZZIE     
GRIFFIN    : MCCONNELL  ORR        LON        MARIANA    VALENTINE  POLLARD    
LUNA       : RONNY      CLINT      CATHERINE  
MCKEE      : LUCIEN     ORTIZ      LAMBERT    KERI       CONCEPCION PETERSON   DUNCAN     
IVANA      : CANDICE    JOHNS      CASSIE     SONYA      
BAKER      : LEVI       ELMA       SETH       
DEENA      : HANNAH     AMELIA     WHITNEY    RICE       BERTIE     EMILY      
WINTERS    : ROSALIE    DIXIE      DUSTY      BROWN      
EMORY      : WHITLEY    SARGENT    MERRILL    SHERMAN    
ROBBIE     : AGNES      JESSIE     FRANKLIN   
WEISS      : DUNCAN     BOOTH      
LAUREN     : BOB        ASHLEE     HENRIETTA  JOAN       
ODELL      : HENSLEY    WILLIE     PASQUALE   CLAYTON    MCLEOD     WOODWARD   DAMON      
KNOWLES    : ARIEL      MAC        WARNER     STACI      BERNARDO   CLARENCE   
ROBBY      : HULL       BRUNO      TAMMIE     DEANDRE    MCLEAN     
STUART     : WIGGINS    BOYER      
OLA        : RAMIRO     KAUFMAN    
GARTH      : PARSONS    KIM        ESMERALDA  RORY       
BEAN       : HORTON     JESSICA    BLAKE      KIP        HUBBARD    
ANITA      : ANTONIO    DUNCAN     JACOBS     DAVID      JILLIAN    
VELMA      : ARRON      ARTHUR     CAROL      CLAUDETTE  SHEPARD    
KRISTIE    : PHILLIPS   DUSTY      BURRIS     
ARRON      : VELMA      PARK       REYNA      MURIEL     HART       CURRY      
JOHANNA    : KRISTINA   SHERYL     ARMSTRONG  RONALD     GINGER     BOBBI      MONROE     
BETTE      : NANETTE    HERMAN     
ROBINSON   : LUISA      SANDOVAL   
TABATHA    : ALFONSO    TRACEY     ALVAREZ    
GRIMES     : TODD       ALVIN      ROSE       BRADSHAW   JULIO      
DARNELL    : BIRD       DWIGHT     MENDOZA    ISIDRO     
GILBERT    : SARA       FOREMAN    STARK      LAURI      
PITTS      : OCONNOR    STARK      
SANTIAGO   : BENJAMIN   LANA       COOKE      HEWITT     TIMOTHY    NOEMI      
CLAYTON    : ODELL      LOWE       
GARRETT    : MARCELINO  MERCER     
MARIA      : WILKERSON  ENGLAND    MARGUERITE GRACIELA   CHERRY     ERIK       
FISCHER    : NORA       DARYL      DELMAR     
CARNEY     : STARK      KIDD       HARPER     
DILLON     : WARD       ANDY       HART       ALISSA     
CASE       : LEE        MENDOZA    
PITTMAN    : DODSON     DIXON      DANIAL     RYAN       TIMMY      CUMMINGS   ODONNELL   LESSIE     
PITTMAN    : 
SCHNEIDER  : WARD       GERARDO    WILBUR     ABEL       CATHRYN    MARSHALL   WINFRED    KEVIN      
SCHNEIDER  : 
WYATT      : CARLSON    BERTIE     
MCLEOD     : ODELL      ADDIE      DEWAYNE    HINTON     CAROLINE   
MCLAUGHLIN : MADELINE   BOOTH      FOWLER     EARL       BUCKLEY    JOHNSTON   
WELCH      : HALL       HUBER      
MCKENZIE   : IRWIN      BUCKNER    BLAIR      COTE       SLOAN      BOWEN      
HART       : HARRINGTON DILLON     ARRON      MARYANNE   MCMAHON    JOSEPH     GOLDIE     
SPENCE     : TERRY      SYBIL      WALSH      BULLOCK    
PENNINGTON : STRICKLAND ISRAEL     CANDY      
JOHNS      : IVANA      ROBERTA    BUDDY      GARRY      FULTON     
HANSON     : NOLAN      GALLOWAY   ALBERT     NORRIS     COLLIN     
NOLAN      : LILIANA    HANSON     VALENTINE  PUCKETT    MAYNARD    
DEJESUS    : POLLARD    WEBB       
BURT       : ADKINS     HOLLIE     
HUNTER     : ARIEL      NIELSEN    HUBER      
MICAH      : CHRISTA    ANTHONY    MILO       
FANNIE     : BORIS      FAULKNER   BIRD       BOBBI      
CORY       : CHRISTINE  SAVANNAH   SHELLEY    LELIA      HENDRICKS  
REYES      : NUNEZ      POPE       
URSULA     : JONI       BURKS      
JARVIS     : BYRD       ALTA       MEDINA     NORMA      ERNA       HOOD       
JUSTINE    : DONA       SUAREZ     JAIME      
MARIBEL    : JOY        SANCHEZ    
RODNEY     : PAMELA     LATISHA    DIXON      ISRAEL     KERRY      
HEBERT     : LEE        MEDINA     FERDINAND  MARCELO    
SILVA      : ERMA       TONIA      
JACLYN     : CHARLIE    HOWELL     BAUER      
PHILLIPS   : DONOVAN    KRISTIE    CONNIE     GILES      BURKS      REILLY     
TOBY       : BOBBIE     DEVON      HAYDEN     BRIGITTE   JULIAN     
GONZALEZ   : COMBS      EVE        ROWE       
ELLIS      : BRIGHT     TAMERA     SONYA      
CHARLIE    : JACLYN     CARSON     BRIAN      TAMMI      ROSA       EFREN      
HOLMAN     : HENSON     SOSA       SUSIE      TANNER     
EDMUND     : ROSALIE    AURELIA    MICHAEL    ERNIE      
FRY        : POLLARD    THOMAS     MARYANNE   SANCHEZ    
CARSON     : CHARLIE    WHITFIELD  HEIDI      DURAN      
HUGHES     : LANA       KRISTOPHER FREDERICK  SOLOMON    
BURGESS    : MEADOWS    ERIKA      WHITNEY    
AUSTIN     : GEORGE     ERICK      
PIERCE     : AHMED      DEANNE     MACIAS     BOYLE      
DENIS      : BRUCE      NEIL       JASPER     REGGIE     
CHANG      : VELASQUEZ  MALDONADO  
HINES      : ELOISE     GABRIELA   NANCY      KATHARINE  EDWIN      LLOYD      
TRACEY     : TABATHA    DEANNE     LEONARD    AMADO      
DARYL      : FISCHER    CRAIG      FRANCISCO  BRIAN      JONI       LOWE       
DIAZ       : COFFEY     MARIE      GUZMAN     KRYSTAL    
CECELIA    : LOTTIE     CONNER     
LARSEN     : FOWLER     EARLENE    EARLE      ANNABELLE  
RICE       : DEENA      CONCEPCION NAVARRO    KANE       HILL       
BRIAN      : COLON      CHARLIE    LEONOR     MONTY      DARYL      CALDWELL   BRYAN      
JOHNATHAN  : JAYNE      MIKE       LEONARD    
BENNIE     : BRYAN      
ERICK      : AUSTIN     KAUFMAN    TANIA      LENORE     ROJAS      MATTHEWS   
LEANNE     : MANUEL     
KENT       : WENDY      KANE       MOLINA     EMILE      CHANCE     
COOLEY     : HARRELL    GONZALES   STACY      
TASHA      : ROSALIE    CARDENAS   
BERT       : PETER      MOHAMED    IGNACIO    DANIELS    
GUY        : FIELDS     DANIELLE   SOLOMON    WHITE      CROSS      HARRIS     
CLARK      : MARISOL    MCCULLOUGH CASANDRA   
TUCKER     : COLON      ALFREDA    JIMMIE     ODONNELL   
VONDA      : CORTEZ     ARMSTRONG  BOBBI      GLOVER     
FROST      : HENDRICKS  ENRIQUE    
NORTON     : RIOS       LAMBERT    ELISEO     ROY        
CRAFT      : SANFORD    GLOVER     HODGE      
LYDIA      : MCDONALD   BARNES     EVE        MADDEN     
FRYE       : NORRIS     KERRI      FRANCESCA  GILES      JACKSON    TYLER      
SELENA     : MILAGROS   MANUEL     COX        
BRIDGETTE  : CARR       SHELLEY    HUGH       JARROD     REGGIE     MAYNARD    JOSEPHINE  
WOLF       : RAYMOND    AMELIA     WILEY      JEANNE     DALTON     
THOMAS     : BAIRD      FRY        GREGORY    NATASHA    BENTLEY    
YOUNG      : HOLDEN     INES       ASHLEE     
DEANDRE    : ROBBY      SYKES      WONG       
KIM        : GARTH      RUSSEL     ALINE      
ENGLAND    : MARIA      KRISTINA   SIMPSON    JOYNER     
CHELSEA    : SCOTT      WALLER     LINDA      DELMAR     DAREN      
AGNES      : ROBBIE     TODD       HEATH      WALLER     TABITHA    JOHNNIE    
SILAS      : JANELLE    ARMSTRONG  JAYNE      
MAGGIE     : HARDY      BOYD       WHITNEY    WIGGINS    LEONEL     VICKI      NOEMI      
HIGGINS    : GONZALO    LINDSAY    KELLER     DANIELLE   
TYREE      : WILLARD    CINDY      BURKS      MARY       
ELOISE     : HINES      ROCKY      PARSONS    KENTON     ANGELITA   
TOM        : ART        
MARGUERITE : MARIA      JOYCE      BROWN      GALLOWAY   
DEWAYNE    : MCCARTHY   MCLEOD     STACI      
FLOYD      : MYERS      
RICHARD    : CONNIE     PEARSON    PHOEBE     BENTLEY    DOROTHEA   BLANCHARD  FOSTER     
EDITH      : COPELAND   ALLISON    KELLEY     PUCKETT    MCFADDEN   
WHITAKER   : SAM        VELASQUEZ  HANEY      
ANNIE      : HORN       CHARLES    NICHOLS    SCOTTIE    JAY        
FLETCHER   : FRANKIE    
CHRISTA    : MARISOL    MICAH      FARLEY     LEONARD    DAVIS      GALEN      SELLERS    
LEONARDO   : MORRIS     KURT       JOHNNIE    LES        ESTELLA    
LANGLEY    : TANYA      BARTON     ALFREDA    
STEFANIE   : HILARIO    DUNLAP     
STEELE     : MARK       LEACH      HENRY      LEMUEL     
BARTLETT   : CURTIS     KASEY      
KLINE      : GILMORE    HAMILTON   SAVAGE     
KRISTOPHER : HUGHES     DWIGHT     OBRIEN     CLARA      JANETTE    WALLS      WONG       
ETTA       : BUTLER     LLOYD      
ISABELLE   : WEBER      ROBT       
AMELIA     : DEENA      WOLF       
TARA       : CAITLIN    PORTER     MYRA       MARISSA    
ALTON      : JOANNA     PARSONS    
BALLARD    : HEIDI      CLARA      BLAIR      
ROMERO     : JARRED     BRANDY     MCLEAN     
RIVERA     : LITTLE     ROBT       TERRELL    
JOY        : MARIBEL    SANTANA    
ALTA       : CHARITY    JARVIS     BRADSHAW   BERGER     MALLORY    DARIN      ALBERT     
MARIE      : IRWIN      DIAZ       ELIJAH     CHARLES    
MCCULLOUGH : CLARK      ABE        DINO       DARCY      BONITA     SOLOMON    
SEARS      : MONTGOMERY NEAL       HENSLEY    REYNOLDS   
NEWMAN     : IRWIN      JESSICA    
JODIE      : COLLEEN    
JAIME      : MERCADO    JUSTINE    WILFREDO   JOSEPHINE  AVA        
BROCK      : HOBBS      LENORE     WATTS      FINLEY     SEBASTIAN  
SLOAN      : MILAGROS   MCKENZIE   FEDERICO   CORNELIUS  
NICOLAS    : THELMA     WARREN     LATISHA    WILBUR     ROSEMARY   
HENSON     : HOLMAN     CLARENCE   ERIK       
CLAUDETTE  : BRENDAN    VELMA      CAIN       
MILLICENT  : MEREDITH   TAYLOR     CASANDRA   MARYELLEN  SIDNEY     SHARON     MADDEN     
RIOS       : NORTON     MIKE       SUAREZ     MEADOWS    WENDY      
XAVIER     : BERNADETTE TREY       LETICIA    PAT        MARTIN     
CONLEY     : LATONYA    LEWIS      FLORENCE   DIXIE      WELLS      
ROSE       : GRIMES     RONNY      MARTIN     
MARYANNE   : MARK       HART       FRY        TRACY      FRANCES    SANTANA    
DAVIS      : CHRISTA    HAROLD     MYERS      DONNY      DONALD     
POTTS      : CRYSTAL    SARA       GLASS      ADELINE    HOWELL     
MEDINA     : HEBERT     JARVIS     BURCH      GOLDIE     
WIGGINS    : STUART     MAGGIE     GERARDO    
BRANDY     : ODESSA     ROMERO     HAZEL      DANIELLE   PUGH       
BERTIE     : ALLISON    DEENA      WYATT      ROSA       HUBER      RODGERS    MARCIA     CHARLES    
BERTIE     : 
BRIGHT     : ELLIS      MCCONNELL  AL         WALL       ARNULFO    
FRANKS     : GIOVANNI   ALVAREZ    LIDIA      
FORBES     : PHOEBE     DUNCAN     ISABELLA   
MARY       : OSCAR      TYREE      MADDEN     
CARLENE    : MERCADO    
HARVEY     : NICHOLS    BETHANY    
MILLER     : DIXIE      
DARRELL    : RAPHAEL    ASHLEY     
FEDERICO   : SLOAN      DAMON      CURTIS     ROY        WINFRED    ROTH       
LEWIS      : MARCELINO  CONLEY     HOLDER     TABITHA    
CECIL      : DONA       STEVENS    EVANGELINE BONNER     
RICO       : SYDNEY     SUAREZ     PORTER     BEASLEY    
LUCIANO    : LENARD     WEBER      NITA       ELBERT     
FRIEDA     : ANNABELLE  MOISES     
PETTY      : CARDENAS   SUZETTE    HOFFMAN    HUBBARD    
TAYLOR     : MOSES      MILLICENT  MADELINE   CLYDE      
ERIKA      : BURGESS    PORTER     LANCASTER  TERRELL    KERR       
WILFREDO   : JAIME      PHELPS     MALDONADO  BURCH      
STRICKLAND : PENNINGTON DODSON     
CASANDRA   : CLARK      MILLICENT  DERICK     HENDERSON  GILL       
FREDDIE    : ALYSON     ERICKA     
ISRAEL     : PENNINGTON RODNEY     MILES      RICHARDS   MCGOWAN    
AMANDA     : STEPHENS   GLADYS     LACY       RUSSO      
MOLLIE     : ED         DELGADO    TANNER     CATHRYN    MUELLER    MARSHALL   
GILL       : CASANDRA   RICHARDS   BRUNO      BERGER     AUBREY     MENDOZA    STEPHENSON 
BONITA     : ALLISON    MCCULLOUGH BRYAN      BARNETT    
GARRY      : JOHNS      JESSIE     PRESTON    
JORDAN     : ESTRADA    DUKE       CRAIG      
KATHY      : PHELPS     
DAPHNE     : COLON      FIELDS     DONNA      
WALSH      : OSCAR      SPENCE     VICKY      RICHARDS   JOSUE      
ANDREA     : LATONYA    HARMON     MONA       LOTTIE     GLASS      
TAMERA     : JOHN       ELLIS      BRAY       
NOE        : BARRERA    CANTRELL   TANNER     HENRIETTA  JUAREZ     WHITE      
GIOVANNI   : FRANKS     NAPOLEON   KENDRA     WEEKS      BEST       KATHARINE  MARCY      GILES      
GIOVANNI   : 
WILL       : PICKETT    SUSAN      CARROLL    ORTIZ      CHARLENE   NELDA      
JOYCE      : MARGUERITE BILLIE     KERRI      GONZALO    
WHITLEY    : EMORY      SUSAN      EVAN       ART        ROJAS      ANGIE      RENA       
WEEKS      : GIOVANNI   LES        KIDD       
HILARIO    : STEFANIE   JERALD     BERNADETTE 
CHAN       : LAUREL     EMILY      
BEST       : MONTY      GIOVANNI   HUBBARD    
FLORES     : MARSH      MARCIA     
JOANNA     : ALTON      FULTON     PETERSON   HUFFMAN    LE         
DONNY      : HARRELL    MOSES      DAVIS      COTE       REYNA      ROBERT     
BRADLY     : CROSS      GENEVA     
BUTLER     : ETTA       CONRAD     CARLA      MERLIN     
VASQUEZ    : ALVIN      CHANDLER   DELGADO    MARTINEZ   ALVAREZ    
NICHOLS    : HARVEY     ANNIE      AVERY      CASEY      FLORENCE   BARBER     TY         
KERRY      : RODNEY     ROXANNE    SIMS       
BORIS      : FANNIE     VAN        CALVIN     DUNLAP     LAWANDA    
VICKY      : WALSH      BELL       KEVEN      
COOK       : CAITLIN    MCMAHON    
ROY        : NORTON     FEDERICO   ADKINS     MCCALL     ANDREWS    MENDOZA    TERRENCE   HOLLAND    
ROY        : 
BOWERS     : WILFORD    DUNLAP     COTE       MARCIA     
HEATH      : MONICA     OLIVER     AGNES      BLANCHARD  CORINNE    
STOUT      : MINNIE     EVANGELINA PALMER     
CLYDE      : TAYLOR     RITA       KNIGHT     LATISHA    HERMAN     
DANIELLE   : GUY        HIGGINS    BRANDY     LANE       NORA       SAMPSON    
PHILIP     : IRWIN      MARGARITO  
HANEY      : WHITAKER   LANE       FINLEY     GLORIA     
RUTLEDGE   : JENNINGS   JESSE      ANDREWS    OBRIEN     SALAZAR    BOYLE      HOWELL     
DONA       : JUSTINE    CECIL      JOHN       MADELINE   COFFEY     GILES      
LOURDES    : TREY       MCCORMICK  SIMONE     HOGAN      
MCFADDEN   : EDITH      
TIMOTHY    : SANTIAGO   MARCUS     ISABELLA   HEWITT     
DIANE      : MORRIS     SHEPARD    BUCHANAN   MCCRAY     MCCARTY    
NEAL       : REEVES     SEARS      JESSICA    HUMBERTO   GLASS      WILLIAMS   CHERRY     ALI        
NEAL       : HOOD       
KATHARINE  : HINES      GIOVANNI   WISE       DAVID      BOWMAN     MORENO     
KRISTINA   : HARRINGTON JOHANNA    ENGLAND    BELL       DORA       
BOBBIE     : LUCIEN     TOBY       PHOEBE     FLORINE    NOEMI      BROWN      BULLOCK    WHITE      
BOBBIE     : 
MANUEL     : LEANNE     SELENA     HOLT       
ANNMARIE   : WINFRED    OLSEN      
SCOTT      : CHELSEA    BURTON     SHEPARD    KARYN      
PECK       : RICHMOND   BOLTON     GALLAGHER  ANNETTE    TANNER     
CANTRELL   : NOE        LINDSAY    SERRANO    VARGAS     COTTON     
JULIO      : GRIMES     SOLOMON    AHMED      CORINNE    CHARLES    
ABEL       : SCHNEIDER  ERNIE      RASMUSSEN  GABRIELA   
ROCCO      : REFUGIO    BRYANT     
FIGUEROA   : HAMILTON   KNOX       BROWN      SAMPSON    COLLIN     TANIA      RAUL       
JULIA      : CARLSON    LUCY       
HENSLEY    : ODELL      SEARS      MALDONADO  CONCEPCION VALENZUELA 
ROXANNE    : KERRY      KEVEN      CINDY      TERENCE    JASPER     ELBERT     PALMER     
BURTON     : SCOTT      CLEMONS    
GLADYS     : AMANDA     GOLDIE     STEPHENSON 
SIDNEY     : LITTLE     ARIEL      MILLICENT  THOMPSON   
WOODWARD   : JOHN       ODELL      OMAR       CAMERON    AUTUMN     FRANCISCO  
LAMBERT    : NORTON     MCKEE      SERGIO     FLEMING    JILLIAN    DEVON      
DEANA      : CLEMENTS   CURRY      
CAROLYN    : BUCKLEY    CLEMONS    DANIEL     
CUNNINGHAM : DUNN       BRYON      AURELIA    
SARA       : GILBERT    POTTS      JANELLE    WELLS      GOODWIN    PACHECO    FERN       
KERI       : MCKEE      CHARLENE   ETHEL      JOHNSTON   
GONZALO    : HIGGINS    JOYCE      BRIGITTE   
DOYLE      : STACI      MATTHEWS   TRUDY      CARISSA    LEON       
ADAM       : LETITIA    ROBERT     CARMINE    COLLEEN    
IGNACIO    : BERT       SOLOMON    ODONNELL   
GREGORY    : THOMAS     AMIE       NIEVES     SUSANNA    LANG       
WOLFE      : BLAKE      KASEY      JARRED     
MILES      : LATONYA    ISRAEL     CONTRERAS  BERNARDO   GATES      ETHEL      
HORN       : HOOPER     ANNIE      HARRELL    RANDOLPH   GRETA      CALLAHAN   SANTANA    
MORRIS     : LEONARDO   DIANE      VELASQUEZ  CONRAD     ALFRED     
STARK      : PITTS      CARNEY     GILBERT    DARIN      SANTANA    DENA       
LORENZO    : INES       HOPKINS    ERIK       SANCHEZ    MOHAMED    
KENNEDY    : LENARD     CORRINE    
ROBLES     : DERICK     BRAY       
LEBLANC    : REUBEN     DYER       ROSARIO    ADELINE    
REUBEN     : LEBLANC    DANIELS    KAUFMAN    BRYAN      DAVENPORT  
LYMAN      : AMADO      PHILLIP    MARVIN     
DALE       : BRIGGS     
DARCY      : BLACKWELL  MCCULLOUGH HUGH       EARLE      TY         MINNIE     
SERGIO     : BALDWIN    LAMBERT    JESSICA    WHITNEY    
DONNA      : MANN       DAPHNE     PARRISH    CASEY      
ENRIQUE    : FROST      NIEVES     GLOVER     LULU       
SHERYL     : JOHANNA    NUNEZ      GATES      MYRA       MERRITT    CHUCK      
MARTINEZ   : VASQUEZ    BARBRA     MAYNARD    DECKER     
ART        : HERRERA    HOBBS      TOM        WHITLEY    AYERS      NITA       
LOTTIE     : CECELIA    ANDREA     MABEL      RANDALL    
CHERI      : ALISSA     OWEN       
COLLIER    : ANNETTE    DELACRUZ   HERSCHEL   CONTRERAS  
HINTON     : MCLEOD     HICKS      OWEN       ARMSTRONG  
HUBER      : WELCH      HUNTER     BERTIE     
MIKE       : RIOS       JOHNATHAN  BULLOCK    WEBB       HOMER      
RONALD     : RAMSEY     JOHANNA    HOUSE      PUCKETT    HARRIET    FORREST    
MCCALL     : PRINCE     ROY        
ALFREDA    : TUCKER     LANGLEY    BRADFORD   
KARYN      : PERCY      SCOTT      
THOMPSON   : SIDNEY     LACEY      RICHARDSON AYERS      SCOTTIE    
HURLEY     : PATEL      MARCELO    RAUL       
HULL       : OCONNOR    ROBBY      SIMONE     QUINCY     MAURICE    
MARCI      : ELIZA      WILFORD    
TAMMI      : CHARLIE    EVANGELINA ENID       
ELISEO     : NORTON     ROTH       HALL       RACHAEL    
CAMACHO    : HOLDEN     BARKER     ERNESTINE  DIXON      
LENORE     : BROCK      ERICK      JESSICA    COLEMAN    LINDSEY    
BOYD       : LITTLE     MAGGIE     BOYER      JAYNE      
HEIDI      : CRYSTAL    BALLARD    CARSON     AHMED      GOLDIE     
CARISSA    : REBEKAH    DOYLE      PETERSON   CINDY      
MALDONADO  : CHANG      HENSLEY    WILFREDO   
CARMINE    : WITT       ADAM       STEVENS    MCCRAY     ANDREW     
PAULETTE   : CHAVEZ     JAYNE      
HOPKINS    : LORENZO    ROSA       BURRIS     
MARYELLEN  : MILLICENT  FULTON     LACEY      EFREN      
MOSS       : BLANCHARD  
CHANDLER   : VASQUEZ    RACHAEL    REINALDO   MORENO     
GRETA      : HORN       SANTANA    ROSALES    
LORRAINE   : ERMA       SOFIA      DEMETRIUS  MCBRIDE    
RASMUSSEN  : HOBBS      ABEL       CLAUDIA    
CROSS      : BRADLY     GUY        
AYERS      : WEBER      ART        THOMPSON   RONNY      FARLEY     
BEACH      : LANCASTER  MARGARITO  HERSCHEL   BETH       
ODOM       : WALTER     FAITH      
KENDALL    : DIONNE     WELLS      RICHMOND   CONTRERAS  COLLINS    
PAM        : HARRINGTON SWEET      ASHLEY     
VICTORIA   : SIMS       MARIANO    PARSONS    
DENA       : KATHERINE  BELL       WARNER     STARK      FLEMING    FINLEY     
LANE       : HANEY      DANIELLE   ASHLEE     
SUAREZ     : LUCIEN     JUSTINE    LEE        RIOS       RICO       WENDI      
MARA       : ESTELLA    MAE        
CLAY       : JESSICA    
HOLLIE     : BURT       GAY        
CHAVEZ     : PAULETTE   VILMA      JAMAR      DON        PETERSEN   
LES        : WEEKS      LEONARDO   ROTH       ROSEANN    JAYNE      
THURMAN    : RAMIRO     MCCARTHY   EVAN       JOAN       DEVON      OBRIEN     
HUGH       : DARCY      BRIDGETTE  COX        
SCHULTZ    : SHARRON    ORTIZ      BARTON     
SAMUEL     : BAIRD      HERSCHEL   QUINN      
FRANCESCA  : FRYE       CONSUELO   WELLS      
HOLCOMB    : LORENA     SHANNON    CASEY      
SHANA      : DANIELS    DEMETRIUS  ZAMORA     HENDERSON  SANCHEZ    ROBERTSON  
BUDDY      : JOHNS      CANDICE    BULLOCK    AYALA      ISIAH      ALYSON     TABITHA    FINLEY     
BUDDY      : 
NIGEL      : SUZETTE    EARL       ANNETTE    
MILLIE     : OLGA       WILEY      WHITFIELD  GARZA      JANICE     
RICHARDS   : GILL       ISRAEL     WALSH      CARDENAS   BREWER     MARSH      
BERGER     : ALTA       GILL       WILKERSON  
BURCH      : MEDINA     WILFREDO   GENARO     DOMINGO    
SOLIS      : LESTER     GLENN      PAYNE      DAREN      MARCUS     
FARLEY     : CHRISTA    AYERS      TREVINO    PASQUALE   
DOMINGO    : BARLOW     BURCH      ALFRED     
DOROTHEA   : FIELDS     RICHARD    WATERS     KRAMER     NAPOLEON   EMILY      
ELIZA      : MARCI      HERSCHEL   SELLERS    DUFFY      ROOSEVELT  ESTELLA    VANCE      
RODRIGUEZ  : GLENN      NORRIS     COX        
JOSEPH     : HART       NIKKI      JARRED     MANNING    BARBRA     
GALEN      : CHRISTA    STANTON    CONSUELO   GUTHRIE    MEADOWS    
MOLINA     : DERICK     KENT       TERRELL    BOLTON     TOWNSEND   CROSBY     
RICARDO    : RAMSEY     MERRITT    RUSS       GIBBS      
CARMELO    : CANTU      EVANGELINE 
RODGERS    : PAGE       BERTIE     
ORR        : GRIFFIN    TRENTON    FERRELL    
DAWN       : ROSETTA    EMILY      REFUGIO    
PETER      : BERT       ANIBAL     JOSEPHINE  HAYDEN     
LULU       : ENRIQUE    NETTIE     JUAREZ     
TREY       : LOURDES    WEBER      XAVIER     JANICE     OTTO       CASTRO     
HENDRIX    : SANDOVAL   WILBUR     
SUSAN      : WILL       WHITLEY    LE         KRAMER     
LUPE       : BURRIS     GOOD       BERNADINE  
JONI       : URSULA     DARYL      WHITNEY    WHITFIELD  
HERMINIA   : NIKKI      
EVERETT    : BRYON      
WEAVER     : BLEVINS    AVERY      WONG       
NETTIE     : LULU       SANFORD    
WILLIS     : HATFIELD   LETITIA    FREEMAN    
VERN       : ISIDRO     
RITA       : CLYDE      NOEMI      
EMILE      : TODD       ALEXANDER  KENT       CLINT      
FERNANDEZ  : WALLER     SUSANNA    GAY        
ALVAREZ    : FRANKS     TABATHA    VASQUEZ    SHEPHERD   HENRIETTA  RICHMOND   
ED         : MARION     MOLLIE     CLARENCE   CUMMINGS   ANNABELLE  CARROLL    
BOYER      : BOYD       STUART     
FLORINE    : BOBBIE     ROTH       SETH       
FOWLER     : LARSEN     VALERIE    MCLAUGHLIN GINGER     ALFONZO    KNIGHT     HOLLAND    
LATISHA    : RODNEY     NICOLAS    CLYDE      GILBERTO   
LETICIA    : XAVIER     CORINNE    KATHLEEN   SYBIL      GALLAGHER  ERNIE      
CARLO      : AURELIA    REESE      MERRILL    KARLA      SCHROEDER  
CONRAD     : BUTLER     MORRIS     HECTOR     FREEMAN    NANCY      
ELVIRA     : VEGA       LON        HOFFMAN    
MERLIN     : BALDWIN    BUTLER     CARDENAS   
KOCH       : VALERIE    CROSBY     HURST      ROD        
PARK       : ARRON      CANDICE    LAURI      BONNER     
KEVEN      : ROXANNE    HAMILTON   VICKY      TREVINO    
ARMSTRONG  : JOHANNA    SILAS      VONDA      HINTON     DELGADO    HENDERSON  
KURT       : LEONARDO   STRONG     
ZAMORA     : FOREST     SHANA      PETERSON   LARSON     VALENZUELA 
SEBASTIAN  : BROCK      
AL         : BRIGHT     WILKERSON  
MARCUS     : TIMOTHY    SOLIS      MCCRAY     ROD        
MICHEAL    : RAMOS      GIBBS      
BLANCHARD  : HEATH      MOSS       JIMENEZ    RICHARD    MALLORY    
TREVINO    : FARLEY     KEVEN      DIONNE     ALEXANDRA  RANDOLPH   REESE      
DUSTY      : WINTERS    KRISTIE    MARCIA     RYAN       MCCLURE    
BRIGITTE   : TOBY       GONZALO    
ROSS       : BALDWIN    GRACE      AUTUMN     GARZA      LEANN      
SONYA      : CARLSON    IVANA      ELLIS      CASTRO     BEASLEY    
LELIA      : BARLOW     CORY       NITA       CLARA      
ROSEANN    : LES        POPE       HALL       CEDRIC     
OTIS       : CONCEPCION ERMA       CAIN       
NORRIS     : FRYE       RODRIGUEZ  HANSON     
SALAZAR    : RUTLEDGE   ERNIE      MARIANA    TINA       
MAE        : MARA       CARLA      
WILEY      : MILLIE     WOLF       
LEVINE     : KELLER     CROSBY     DARIN      MORENO     
NITA       : HOBBS      LUCIANO    LELIA      ART        
CATHERINE  : LUNA       BARBER     
BARKER     : PHOEBE     CAMACHO    LOWE       
JESSIE     : ROBBIE     GARRY      SANFORD    VAN        KRYSTAL    
PATEL      : HURLEY     MARGERY    VALENTINE  
LORI       : HAMILTON   WHITE      STEVENSON  WOODARD    
TERRI      : MORROW     DYLAN      ALFONSO    
MAYS       : FRANCIS    KRISTEN    TABITHA    ELVA       
FOREMAN    : GILBERT    LANG       NICHOLSON  
ROCKY      : ELOISE     HERRERA    RICHMOND   
GERARDO    : BARRY      SCHNEIDER  WIGGINS    ESTES      AYALA      DANA       
FRANCES    : CAITLIN    MARYANNE   TERRY      JANICE     
EDGARDO    : RAYMOND    MATHIS     LEMUEL     
PORTER     : TARA       ERIKA      RICO       NIKKI      LOGAN      
NANETTE    : BETTE      HODGE      INA        HEWITT     
PACHECO    : ALBA       HARRELL    SARA       ERICKA     
KATHLEEN   : CASTILLO   LETICIA    FERDINAND  BOB        
SHIRLEY    : JILL       NORA       RENA       JEREMY     
AURELIA    : TRICIA     EDMUND     CARLO      FLOSSIE    CUNNINGHAM ROBERTSON  
POPE       : RAMOS      REYES      ROSEANN    CONCEPCION DONALD     LEROY      
VICTOR     : PETERSON   RODERICK   
DANIELS    : REUBEN     SHANA      CLEMENTS   BERT       BROWN      MARGERY    LORENA     GALLAGHER  
DANIELS    : 
MARTHA     : AMIE       SALVATORE  
BRIANA     : SIMS       
REYNA      : ARRON      DONNY      COFFEY     
QUINCY     : HULL       ELLIOTT    MITCHELL   
HOLDER     : LEWIS      LUISA      GALLAGHER  HELENA     FREDRIC    GRACE      SOFIA      
NAPOLEON   : DONOVAN    SWEET      GIOVANNI   DOROTHEA   MARKS      
GABRIELA   : HINES      ABEL       SUZETTE    ENGLISH    CAROLE     
BETHANY    : KNOX       HARVEY     EVE        HERRING    
SHEPARD    : SCOTT      VELMA      DIANE      ANTONIA    PARRISH    
LAUREL     : CHAN       AMIE       JAYNE      JOHNSON    ASHLEE     BULLOCK    
FLORENCE   : CONLEY     NICHOLS    GARNER     ELDON      
ROSA       : BERTIE     HOPKINS    CHARLIE    DANA       MALLORY    TERRENCE   THADDEUS   
HAROLD     : WALTON     HIRAM      DAVIS      MYRA       LAURI      
SANDOVAL   : HENDRIX    ROBINSON   TONI       
HENRIETTA  : LAUREN     NOE        ALVAREZ    NANCY      
WHITFIELD  : HANNAH     CARSON     MILLIE     JONI       MERLE      WILKERSON  
CLARA      : BALLARD    KRISTOPHER LELIA      VERNON     
FULTON     : JOANNA     MARYELLEN  JOHNS      
ROBIN      : BARNES     FULLER     MAURICE    ROTH       HARPER     
WALTER     : ODOM       ARTHUR     HAWKINS    LE         FLYNN      
JANINE     : HORTON     HOWELL     SAVAGE     REYNOLDS   STEVENSON  
BENTLEY    : RICHARD    THOMAS     HEAD       LESSIE     
JASPER     : NICOLE     DENIS      ROXANNE    SHEPHERD   
ERNESTINE  : CARLSON    DERICK     CAMACHO    FAULKNER   JACOB      BRUNO      JAY        
GARZA      : MILLIE     ROSS       HEAD       RODERICK   GAY        
EVANGELINA : TAMMI      MONTGOMERY STOUT      JACOBS     AUGUSTINE  BASIL      
SHAWN      : TERRENCE   MONROE     
INGRID     : ROBT       SHARON     EARLE      MOHAMED    TERENCE    HOFFMAN    
LINDA      : CHELSEA    KIP        
SIMS       : KERRY      VICTORIA   BRIANA     LEONARD    STACY      MOODY      
MURIEL     : ARRON      ANDY       SANTANA    COLLINS    
ANNETTE    : COLLIER    PECK       NIGEL      KENTON     
LORIE      : TERRENCE   BARR       
MYRA       : TARA       HAROLD     SHERYL     WENDY      
GLASS      : POTTS      ANDREA     NEAL       PATSY      STEVENSON  
LINDSAY    : HIGGINS    CANTRELL   CHARITY    TABITHA    MYERS      
ROBT       : RIVERA     INGRID     LANA       ISABELLE   JESSICA    
PRUITT     : SCHROEDER  PASQUALE   DEANNE     
FOSTER     : RICHARD    HOLT       MARSH      ALISSA     CROSBY     DUFFY      
VINCENT    : KASEY      CASTRO     JAMAR      
NOELLE     : STEVENSON  LON        
GOODMAN    : MARCY      
RYAN       : PITTMAN    DUSTY      HODGE      BATTLE     CASTRO     
RICHMOND   : PECK       KENDALL    ALVAREZ    ROCKY      HAYDEN     
LUCAS      : BUCKNER    SANFORD    RONNY      FORREST    PUGH       RANDOLPH   
DYER       : LEBLANC    GLORIA     MARCELO    COLLIN     
RUSSELL    : ANTONE     HUFFMAN    HOWELL     AUGUSTINE  ONEIL      
BOB        : LAUREN     KATHLEEN   VEGA       COFFEY     
MARIANA    : BALDWIN    OCTAVIO    GRIFFIN    SALAZAR    ELIJAH     REYNOLDS   
CRANE      : LACY       JEREMY     
ADELINE    : KATY       POTTS      LEBLANC    MARCEL     
GINGER     : WARNER     JOHANNA    FOWLER     FERRELL    
NANNIE     : JANELLE    LEONEL     COX        
MALLORY    : BLANCHARD  GILMORE    ALTA       ROSA       HARRISON   NATASHA    
REESE      : CARLO      TREVINO    SOSA       ENID       
WILBUR     : SCHNEIDER  HENDRIX    NICOLAS    CONCEPCION 
CLEVELAND  : SYKES      MERRITT    
HOLT       : LUCILLE    MANUEL     FOSTER     DIXON      
LEONEL     : NANNIE     MAGGIE     REGINA     
BOOTH      : LOIS       MCLAUGHLIN WEISS      
FERN       : BARRY      SARA       QUINTON    ELINOR     
CALDWELL   : BRIAN      SONNY      ONEIL      
WILFORD    : BOWERS     MARCI      SYBIL      LOTT       
HENDERSON  : CASANDRA   SHANA      ARMSTRONG  BRADLEY    
LANCASTER  : BEACH      SOTO       ERIKA      BRYAN      
MARGARITO  : PHILIP     BEACH      MILLS      SCHWARTZ   
BOLTON     : PECK       MOLINA     
BRUCE      : TRICIA     DENIS      WILLARD    VALENTINE  NOEMI      KRAMER     
DENNIS     : KYLE       PETERSON   
HAYS       : DUNCAN     
SUZETTE    : NIGEL      GABRIELA   PERRY      PETTY      STANLEY    
BROWN      : MARGUERITE FIGUEROA   WINTERS    BOBBIE     DANIELS    
KELLEY     : WILLARD    EDITH      SIMONE     PATRICK    VAUGHN     
RODRIQUEZ  : SWANSON    DONALD     ALI        
JERALD     : HILARIO    GILLESPIE  BRAY       FRANKLIN   
DELACRUZ   : COLLIER    LUCILLE    NIKKI      SHELLEY    
FREDRIC    : VELASQUEZ  HOLDER     DYLAN      
ANA        : MATTHEWS   
JIMMIE     : TRENTON    TUCKER     FRANCIS    RUSSO      
MYERS      : AVIS       FLOYD      DAVIS      LINDSAY    GENEVA     BENTON     BUCKLEY    
EARL       : NIGEL      MCCONNELL  MCLAUGHLIN 
VIRGIE     : QUINN      
STEVEN     : COPELAND   SAUNDERS   HERSCHEL   
ANTONIA    : PICKETT    SHEPARD    EVANGELINE HICKS      ASHLEE     
LIZZIE     : OSCAR      ALICIA     HAYDEN     
CATHRYN    : JANELLE    SCHNEIDER  MOLLIE     EVANGELINE 
MARGERY    : BLEVINS    PATEL      PHOEBE     DANIELS    DARRYL     CARR       ANTHONY    GIBSON     
MARGERY    : 
SNOW       : LEONOR     ARTHUR     
WISE       : ANIBAL     KATHARINE  LEONARD    CHARLES    SUSANNA    
AUGUSTINE  : EVANGELINA RUSSELL    FLEMING    
GLORIA     : DYER       PERRY      HANEY      JIM        MACDONALD  NAVARRO    MACK       
CONTRERAS  : MILES      COLLIER    KENDALL    SANTANA    MARIANO    OWEN       
FLEMING    : VELASQUEZ  DENA       AUGUSTINE  MCKAY      LAMBERT    
CAMERON    : WALDO      WOODWARD   NIEVES     TANYA      AURORA     
ESMERALDA  : TRENTON    GARTH      SOFIA      
HICKS      : HINTON     ANIBAL     ANTONIA    TAMMY      FAITH      
OMAR       : WOODWARD   LESLIE     BARLOW     ROSALINDA  
GEORGE     : AUSTIN     STEWART    WILLIAMS   WILLIE     SALINAS    
AURORA     : LENARD     CAMERON    ANGELITA   SAVAGE     
PRISCILLA  : BRENDAN    GALLOWAY   KAUFMAN    
CALLAHAN   : HORN       AYALA      HEWITT     DEAN       
ROSEMARY   : NICOLAS    PARRISH    MOHAMED    EVE        KRYSTAL    
FRANCIS    : MAYS       JIMMIE     HALL       KIDD       
TAMMY      : JAMAAL     HICKS      MORROW     SELLERS    HARMON     
LEANN      : LENARD     ROSS       TRAN       
ERICKA     : FREDDIE    PACHECO    
JANETTE    : KRISTOPHER BARR       TURNER     RENA       
EARLENE    : LARSEN     MENDOZA    ANDREWS    ELBERT     SUSANNA    
JACOB      : IRIS       ERNESTINE  LORENA     LORAINE    MOSLEY     
CONNER     : OLIVER     CECELIA    NEIL       SHERRI     
DELMAR     : FISCHER    CHELSEA    MAYER      
TATE       : CRYSTAL    WILCOX     LEONARD    
KIP        : CARLSON    MAC        LINDA      BEAN       MARCY      GRAHAM     
WALLS      : DIONNE     KRISTOPHER 
NIKKI      : JOSEPH     HERMINIA   PORTER     DELACRUZ   CORTEZ     DANIAL     
GUTHRIE    : WALTERS    GALEN      
ASHLEE     : LAUREN     LANE       YOUNG      LAUREL     ANTONIA    
MASSEY     : SAMPSON    TEDDY      MACDONALD  
TOMMY      : FOREST     JULIET     SUSIE      CORINNE    
STEVENS    : CECIL      CARMINE    ENID       TRENT      
COLLEEN    : KNOX       JODIE      ADAM       CLINT      
VEGA       : ELVIRA     BOB        
TERRY      : SPENCE     FRANCES    MORROW     BOWMAN     DEAN       
NORA       : FISCHER    SHIRLEY    DANIELLE   
JESSE      : RUTLEDGE   HARRELL    WINFRED    MILDRED    
ASHLEY     : PAM        DARRELL    HOWELL     
BERNADETTE : BUCK       XAVIER     HILARIO    MATTHEWS   
TIMMY      : MCKAY      PITTMAN    MABEL      GRACIELA   WILKINSON  
JANICE     : FRANCES    MILLIE     TREY       CLAUDIA    BRYANT     MILO       
MONTOYA    : MATHIS     
EFREN      : HANNAH     CHARLIE    MARYELLEN  JESSICA    ALFRED     
HERIBERTO  : DUKE       ROBERTSON  ESTRADA    
SHARON     : INGRID     MILLICENT  ELBERT     TY         
JUANITA    : MERCEDES   JEAN       MOISES     
AHMED      : TILLMAN    WARNER     PIERCE     HEIDI      JULIO      BETH       WILKINSON  LYNN       
AHMED      : 
CARR       : BRIDGETTE  ERIN       MARGERY    REGGIE     
JARROD     : BARRY      BRIDGETTE  JOHNNIE    
STEWART    : DUNN       GEORGE     ARTHUR     GONZALES   
RAY        : WILLIAMS   OLSON      
TRAN       : LEANN      TRUDY      
MCCORMICK  : LOURDES    HARRELL    HUFFMAN    SOFIA      DANA       
JUAREZ     : LILA       LULU       FOREST     NOE        SONNY      
VALENTINE  : NOLAN      PATEL      BRUCE      GRIFFIN    DICK       
SERRANO    : CANTRELL   CANTU      KENTON     
DUKE       : HERIBERTO  JORDAN     WEBB       ESTELLA    SHELLEY    
HECTOR     : CONRAD     REYNOLDS   DEWITT     
LACY       : CRANE      AMANDA     WILKINSON  BEASLEY    SUSANNA    
AVERY      : NICHOLS    WEAVER     BYRD       ALEXANDRA  GOODWIN    
MELBA      : HERRERA    DELGADO    CINDY      
GOLDIE     : MOSES      MEDINA     GLADYS     ANDERSON   HART       HEIDI      
ISIAH      : ELMA       BUDDY      JOYNER     
JEREMY     : SHIRLEY    CRANE      ROWE       
BARBER     : NICHOLS    CATHERINE  JAMAR      TY         
LOWE       : CLAYTON    BARKER     DARYL      HUDSON     
ALFONZO    : FOWLER     NATASHA    DICK       
BUCKLEY    : CAROLYN    BARRY      MCLAUGHLIN MYERS      DELANEY    LEMUEL     SAVAGE     
CRAIG      : DARYL      JORDAN     JARED      
ROBBINS    : HERRERA    ESTEBAN    RUSSEL     
MABEL      : LOTTIE     TIMMY      ANDERSON   PATRICK    MILO       ELINOR     
RUSS       : FOREST     MOSES      RICARDO    
KIDD       : CARNEY     WEEKS      FRANCIS    HENDRICKS  JOSE       
FAULKNER   : ERNESTINE  TRENTON    LITTLE     FANNIE     DAVID      
SAMPSON    : FIGUEROA   MASSEY     DANIELLE   
ANDREWS    : LITTLE     HOUSTON    RUTLEDGE   ROY        EARLENE    GENARO     
SALINAS    : GEORGE     CONSUELO   MONROE     
DELANEY    : BUCKLEY    LACEY      CALVIN     
AVA        : JAIME      NEWTON     HOUSE      
NEIL       : BLACKWELL  DENIS      CONNER     RORY       GALLAGHER  BREWER     EVE        
RAYMOND    : WOLF       EDGARDO    GOMEZ      LORAINE    HUNT       
BUCHANAN   : ISSAC      DIANE      ESTRADA    
EMILY      : PRINCE     IRIS       DAWN       DEENA      CHAN       DOROTHEA   ALEXANDRA  GRACIELA   
EMILY      : 
CONCEPCION : ANTONE     RICE       HENSLEY    OTIS       POPE       MCKEE      WILBUR     ALBERTO    
CONCEPCION : CAIN       
KAUFMAN    : OLA        ERICK      REUBEN     REUBEN     PRISCILLA  
BRADLEY    : HENDERSON  COLEMAN    KENTON     
JAYNE      : JOHNATHAN  SILAS      LAUREL     BOYD       PAULETTE   LES        LARSON     ROBERTSON  
JAYNE      : 
SIMONE     : LOURDES    HULL       KELLEY     MARION     IRVIN      WASHINGTON 
SHEPHERD   : ALVAREZ    JASPER     ROBERTA    ANGELITA   TABITHA    
WILLIAMS   : BARRERA    FLOSSIE    GEORGE     RAY        NEAL       
MCINTYRE   : KRYSTAL    POLLARD    LEROY      
WILKINSON  : LACY       TIMMY      AHMED      DEAN       
CAROLINE   : MCLEOD     LUISA      FRANKIE    
HOMER      : MIKE       JACOBS     DAMON      MOSLEY     
PARRISH    : DONNA      ROSEMARY   HORTON     SHEPARD    HOLLOWAY   
COX        : HOLDEN     JIMENEZ    HUGH       SELENA     RODRIGUEZ  NANNIE     PARSONS    
STACI      : KNOWLES    DOYLE      DEWAYNE    CHUCK      
JACOBS     : EVANGELINA HOMER      ANITA      SYBIL      NICHOLSON  
ROSARIO    : LEBLANC    HAMILTON   MOODY      HARRIS     DORA       
MEADOWS    : BURGESS    COOKE      RIOS       GALEN      GALLOWAY   
BRADSHAW   : GRIMES     ALTA       LESTER     JOHNNIE    KASEY      
MUELLER    : MOLLIE     DARIN      LAWANDA    
HAZEL      : BRANDY     BURRIS     WELDON     
JARRED     : ROMERO     JOSEPH     WOLFE      
BRUNO      : OLIVER     ROBBY      GILL       ERNESTINE  BILLIE     
SWANSON    : RODRIQUEZ  CARDENAS   
CARROLL    : CHARLOTTE  WILL       TODD       ED         MILDRED    HARMON     FRANKIE    
VALENCIA   : PAGE       MERCEDES   HOUSTON    WATERS     ENID       
PRESTON    : GARRY      HUFFMAN    
PEREZ      : MONTY      TERENCE    RUSSO      
MARCELO    : HURLEY     DYER       HEBERT     JEANNE     
MILLS      : MARGARITO  BLAKE      RENA       
GENEVA     : MYERS      LUCILLE    BRADLY     HARMON     
ERMA       : LATONYA    SILVA      LORRAINE   OTIS       KNOX       PAT        JOHNSON    
TINA       : SALAZAR    JOAN       TANNER     
TOWNSEND   : MOLINA     
BRENTON    : WARREN     MARGARITA  GRACIELA   SHANNON    JAY        
DELORIS    : MONROE     OBRIEN     LYNN       
CANTU      : CARMELO    SERRANO    LEACH      RICK       
PAYNE      : SOLIS      ALEXANDER  STANTON    KANE       
ANTHONY    : MICAH      MARGERY    
DELGADO    : EUGENIA    MOLLIE     VASQUEZ    ARMSTRONG  MELBA      SANFORD    JULIE      GILES      
DELGADO    : DICK       ELLIOTT    
MCCRAY     : MARCUS     DIANE      CARMINE    HUNT       LEONARD    
FREEMAN    : CONRAD     WILLIS     
ESTEBAN    : ROBBINS    MCKAY      QUINN      VARGAS     PUCKETT    HELENA     LUCY       
GRACE      : ROSS       HOLDER     
ADAMS      : GALLOWAY   DWIGHT     
RICKY      : JIMENEZ    TERENCE    DON        
LORENA     : HOLCOMB    JACOB      DANIELS    INA        
KARLA      : CARLO      ROWE       
WOODARD    : LORI       HARRISON   OLSEN      
JARED      : CRAIG      HERSCHEL   
WELLS      : SARA       KENDALL    CONLEY     FRANCESCA  CEDRIC     
NEWTON     : AVA        RODERICK   MARCIA     
BURRIS     : LUPE       HAZEL      KRISTIE    HOPKINS    
MARCY      : GOODMAN    GIOVANNI   KIP        
BENITO     : BARNETT    TRACY      
LARSON     : COPELAND   CHARITY    ZAMORA     JAYNE      JOHNNIE    ETHEL      
VICKI      : MAGGIE     
DONALD     : POPE       RODRIQUEZ  DAVIS      KRISTEN    LOTT       
WENDY      : KENT       MYRA       RIOS       
AUBREY     : FOX        DUNN       GILL       KYLE       
DAVID      : ANITA      KATHARINE  FAULKNER   WINFRED    
COMPTON    : ELIJAH     EVANGELINE MARTIN     
PUGH       : FOREST     BRANDY     LUCAS      SELLERS    KYLE       
MENDOZA    : CASE       EARLENE    DARNELL    GILL       ROY        BENTON     
KEITH      : LESTER     ADDIE      MONA       
MERLE      : WHITFIELD  CARLA      MORENO     
BREWER     : SOTO       RICHARDS   NEIL       POOLE      
VERNON     : MCCONNELL  CLARA      CRISTINA   LE         
SCOTTIE    : MARISOL    BARRY      ANNIE      THOMPSON   TEDDY      WILLIE     MICHAEL    
ALICIA     : LIZZIE     EVE        
EARLE      : LARSEN     DARCY      INGRID     LE         
IAN        : ABRAHAM    MATHIS     
JEAN       : JUANITA    TONIA      JEANNE     RICHARDSON 
SAUNDERS   : STEVEN     CONSTANCE  
DECKER     : MARTINEZ   TERRENCE   KRISTINE   REFUGIO    
JOSUE      : WALSH      
SYKES      : MARK       CLEVELAND  DEANDRE    RONNY      MILDRED    DEWITT     TRACY      
MILDRED    : CARROLL    BARRERA    JESSE      SYKES      WASHINGTON 
SYBIL      : SPENCE     WILFORD    JACOBS     CAITLIN    LETICIA    ETHEL      BRIGGS     
DEANNE     : PIERCE     TRACEY     PRUITT     ROWE       HILL       
BONNER     : STEPHENS   CECIL      PARK       ADKINS     WASHINGTON 
NIELSEN    : HUNTER     TY         LORAINE    COTTON     
ENGLISH    : CASTILLO   GABRIELA   KELLY      MARCEL     
HOUSE      : RONALD     AVA        
LEONARD    : CHRISTA    SIMS       WISE       TATE       TRACEY     JOHNATHAN  MCCRAY     SHELLEY    
LEONARD    : 
WATERS     : DOROTHEA   VALENCIA   EARNEST    NICHOLSON  
BENTON     : MYERS      MENDOZA    ELDON      MCMAHON    
HARMON     : ANDREA     TAMMY      CARROLL    GENEVA     
DIXON      : RAMSEY     PITTMAN    RODNEY     HOLT       CAMACHO    FULLER     FRANKLIN   
ISABELLA   : FORBES     TIMOTHY    BEASLEY    ROSALES    WEBB       
GARNER     : FLORENCE   BRYANT     ANGIE      
MOODY      : ROSARIO    HERRERA    BARLOW     SIMS       ROMAN      LORNA      
LUISA      : ROBINSON   HOLDER     CAROLINE   ALBERTO    MAURICE    HUDSON     
PUCKETT    : NOLAN      EDITH      RONALD     ESTEBAN    
WALL       : CHANEY     TRICIA     BRIGHT     AISHA      HEWITT     MCGOWAN    
DEMETRIUS  : MONICA     ABE        SHANA      LORRAINE   HARRISON   BOYLE      SHANNON    SHARRON    
DEMETRIUS  : ERNA       
MOHAMED    : BERT       LORENZO    INGRID     ROSEMARY   WHITNEY    AMADO      
GIBSON     : MARGERY    BRYANT     TRENT      POLLARD    
SOLOMON    : GUY        JULIO      IGNACIO    HUGHES     MCCULLOUGH LINDSEY    ANNABELLE  
GOOD       : LILIANA    LUPE       CLAUDIA    
ELVA       : MAYS       DEAN       
NIEVES     : HAMILTON   GREGORY    ENRIQUE    CAMERON    GLENN      TRUDY      HOOD       
JEWELL     : CHANEY     KRYSTAL    BEASLEY    
JOSE       : KIDD       ANASTASIA  
DIXIE      : WINTERS    CONLEY     MILLER     HAMILTON   WALLER     COLEMAN    ALI        
GRAY       : TRICIA     PATRICK    KRYSTAL    
FULLER     : ROBIN      DIXON      CHARLENE   
ELDON      : BENTON     FIELDS     FLORENCE   MARCIA     ALINE      
JESSICA    : BEAN       NEWMAN     NEAL       SERGIO     LENORE     CLAY       ROBT       EFREN      
JESSICA    : 
GILLESPIE  : JERALD     WARREN     VERA       HENRY      
ALEXANDRA  : TREVINO    AVERY      EMILY      TANNER     
IRA        : JAMAAL     
BIRD       : DARNELL    FANNIE     
TAMMIE     : ROBBY      LUCY       ARNULFO    
RORY       : MARION     NEIL       GARTH      SARGENT    
MERCER     : GARRETT    EARNEST    WASHINGTON 
STANTON    : GALEN      PAYNE      
GRACIELA   : TIMMY      BRENTON    MARIA      EMILY      
COLLIN     : DYER       HANSON     FIGUEROA   DARIN      
BOBBI      : WITT       MCMILLAN   JOHANNA    FANNIE     VONDA      
MARKS      : NAPOLEON   KERR       
ADKINS     : BURT       ROY        BONNER     TONI       SANTANA    JAMEL      
HERMAN     : LEE        BETTE      CLYDE      CHARMAINE  
IRVIN      : SIMONE     AIDA       
PATRICK    : KELLEY     MABEL      GRAY       DONOVAN    SHERMAN    CAROL      
VALENZUELA : LENARD     HENSLEY    ZAMORA     HOLLOWAY   MINNIE     
WILKERSON  : MARIA      AL         BERGER     WHITFIELD  
ANTONIO    : MERCEDES   ANITA      DIONNE     TEDDY      
HERSCHEL   : COLLIER    BEACH      SAMUEL     ELIZA      JARED      STEVEN     TONI       HENRY      
HERSCHEL   : 
DWIGHT     : DARNELL    KRISTOPHER ADAMS      SANTANA    
HURST      : COPELAND   KOCH       TRACY      ALYSON     
PAT        : LUCILLE    ERMA       XAVIER     POLLARD    
LAURI      : PARK       GILBERT    HAROLD     QUINTON    
HENRY      : STEELE     GILLESPIE  HERSCHEL   WELDON     
MARSH      : FLORES     FOSTER     RICHARDS   
NOEMI      : LUCILLE    BOBBIE     RITA       BRUCE      SANTIAGO   MAGGIE     BARBRA     CHRISTINE  
NOEMI      : DANIEL     
CHRISTIAN  : CLEMENTS   LESSIE     
SHANNON    : HOLCOMB    BRENTON    DEMETRIUS  BARBRA     BARR       
ARNULFO    : BRIGHT     TAMMIE     MAXINE     WILLIE     RICHARDSON 
SETH       : BRYON      BAKER      FLORINE    ELIJAH     ELLIOTT    
INGRAM     : BENJAMIN   WALLER     KERR       BRADFORD   
ALFRED     : MORRIS     DOMINGO    EFREN      MITCHELL   MARCEL     
CHRISTINE  : CORY       NUNEZ      NOEMI      PHILLIP    
CINDY      : STACIE     TYREE      ROXANNE    CARISSA    MELBA      HUMBERTO   KENDRA     
DAVENPORT  : REUBEN     GATES      
SANFORD    : CRAFT      NETTIE     JESSIE     LUCAS      DELGADO    BAUER      
COLEMAN    : LENORE     BRADLEY    DIXIE      DORA       ROOSEVELT  
JIM        : LEONOR     GLORIA     MARSHALL   JOHNSON    
GENARO     : ESTES      BURCH      ANDREWS    
CORINNE    : LETICIA    HEATH      JULIO      TOMMY      
ELBERT     : LUCIANO    SHARON     ROXANNE    EARLENE    ADDIE      
DAREN      : SOLIS      CHELSEA    TANYA      LAWANDA    
YVETTE     : INES       ISIDRO     
MORROW     : TERRI      TAMMY      TERRY      COLON      
GUZMAN     : DIAZ       ERNA       DANIAL     HELGA      
NORMA      : ISSAC      JARVIS     THADDEUS   
DAMIAN     : LANA       AYALA      
HUMBERTO   : NEAL       CINDY      MCDONALD   JOHN       WARREN     CONSUELO   CURTIS     
DICK       : VALENTINE  BARRY      ALFONZO    DELGADO    
SONNY      : CALDWELL   JUAREZ     CARLA      
MATHIS     : EDGARDO    MONTOYA    IAN        REYNOLDS   
JULIET     : TOMMY      HOLDEN     TURNER     CORRINE    
KRISTEN    : MAYS       DONALD     HOFFMAN    
SARGENT    : BLACKWELL  EMORY      RORY       CHERRY     RENA       
MCCARTY    : JILL       DIANE      CLINT      
TANIA      : ERICK      ERICK      FIGUEROA   
JULIE      : DELGADO    SOFIA      
RONNY      : SWEET      LUNA       ROSE       AYERS      LUCAS      SYKES      HARRISON   PARKS      
RONNY      : 
HENDRICKS  : ESTES      FROST      KIDD       CORY       STANLEY    WONG       
BOWMAN     : TERRY      ALVIN      KATHARINE  RAUL       
HARRISON   : DEMETRIUS  RONNY      MOSES      MALLORY    WOODARD    WATTS      
DORA       : PERRY      COLEMAN    KRISTINA   ROSARIO    HODGE      JOSH       
ELIJAH     : MARIANA    COMPTON    SETH       MARIE      BOYLE      TRAVIS     
ERICKSON   : HAWKINS    BARBRA     
TEDDY      : SCOTTIE    ANTONIO    MASSEY     
REFUGIO    : CHRISTI    ROCCO      DAWN       DECKER     JOHNSTON   KERR       
LOTT       : WILFORD    MCMILLAN   DONALD     
WATTS      : BROCK      HARRISON   STANLEY    
GILES      : PHILLIPS   DELGADO    FRYE       GIOVANNI   DONA       
VAN        : BORIS      JESSIE     
BULLOCK    : MIKE       BUDDY      SPENCE     BOBBIE     LAUREL     
GOODWIN    : SARA       AVERY      MARGARITA  RAPHAEL    MARCIA     
TORRES     : LESLIE     SOTO       HUDSON     HELENA     WONG       BILLIE     
WALLER     : PAMELA     CHELSEA    FERNANDEZ  DIXIE      INGRAM     AGNES      VAUGHN     
RAPHAEL    : DARRELL    GOODWIN    JACKSON    
ELLIOTT    : MARGARITA  QUINCY     DELGADO    SETH       
MACDONALD  : GLORIA     MASSEY     
JAMAR      : CHAVEZ     BARBER     SWEET      VINCENT    JOAN       BRYAN      
LEMUEL     : STEELE     EDGARDO    JACKIE     BUCKLEY    
DARIN      : STARK      MUELLER    COLLIN     ALTA       LEVINE     
ROJAS      : ERICK      WHITLEY    CROSBY     
BOYLE      : LANA       DEMETRIUS  ELIJAH     PIERCE     RUTLEDGE   DARRYL     
KENTON     : DUNN       SERRANO    BRADLEY    ELOISE     ANNETTE    PETERSEN   
MOISES     : SWEET      FRIEDA     JUANITA    GREENE     
AUTUMN     : ROSS       WOODWARD   
ROOSEVELT  : COLEMAN    ELIZA      
QUINN      : VIRGIE     ESTEBAN    SAMUEL     FORREST    GREENE     KYLE       
NAVARRO    : RICE       GLORIA     
FAITH      : HERBERT    ODOM       HICKS      
CAIN       : CLAUDETTE  OTIS       CONCEPCION CORRINE    
CHANCE     : KENT       PASQUALE   
BRANDI     : BURKS      MILO       
ROSALINDA  : TRICIA     OMAR       CONSTANCE  
PATSY      : JACKIE     GLASS      JOHN       MITCHELL   JOSEPHINE  
SOSA       : MAC        HOLMAN     REESE      BATTLE     DEVON      TRACY      
HODGE      : NANETTE    RYAN       DORA       ANDERSON   CRAFT      TERRELL    CORNELIUS  STACY      
HODGE      : 
NANCY      : HINES      CONRAD     HENRIETTA  
LON        : WALDO      GRIFFIN    ELVIRA     NOELLE     NGUYEN     
TERRELL    : RIVERA     MOLINA     HODGE      ERIKA      
MERRITT    : MONTY      RICARDO    CLEVELAND  SHERYL     CURTIS     RANDALL    
MATTHEWS   : DOYLE      ANA        BERNADETTE ROSETTA    ERICK      
CEDRIC     : WELLS      ROSEANN    
MAXINE     : INES       BRENDAN    ARNULFO    TRUDY      
SUSIE      : TOMMY      HOLMAN     
HALL       : MCCONNELL  WELCH      ROSEANN    FRANCIS    ELISEO     
ALYSON     : FREDDIE    DUNN       BUDDY      HURST      
CHERRY     : SARGENT    MARIA      NEAL       MICHAEL    
CORTEZ     : VONDA      NIKKI      MCKAY      
EVAN       : WHITLEY    THURMAN    
PHILLIP    : LYMAN      CHRISTINE  ANNABELLE  
SUSANNA    : GREGORY    FERNANDEZ  WISE       EARLENE    LACY       
MANNING    : JOSEPH     
CARDENAS   : MAVIS      PICKETT    TASHA      PETTY      RICHARDS   SWANSON    MERLIN     
OTTO       : TREY       ETHEL      HELENA     
KYLE       : DENNIS     AUBREY     PUGH       QUINN      
EARNEST    : WATERS     MERCER     CHRISTI    BURKS      FERRELL    
OLSEN      : ANNMARIE   WOODARD    
WILLIE     : ODELL      GEORGE     SCOTTIE    ARNULFO    
SCHROEDER  : PRUITT     CARLO      KASEY      MCCLURE    MARIANO    GAY        
TONI       : RAMIRO     SANDOVAL   ADKINS     HERSCHEL   TRICIA     
BILLIE     : JOYCE      BRUNO      KATY       TORRES     DARRYL     
OLSON      : RAY        CONSTANCE  
ESTELLA    : MARA       LEONARDO   ELIZA      DUKE       
ALBERTO    : CONCEPCION LUISA      MACK       DUNCAN     KASEY      ANGELITA   ROBERTSON  
SHARRON    : SCHULTZ    DEMETRIUS  
EDWIN      : HINES      MACIAS     LORAINE    
WHITNEY    : DEENA      MAGGIE     JONI       BURGESS    SERGIO     MOHAMED    KRISTINE   
CURRY      : DEANA      ARRON      FUENTES    
HUFFMAN    : YANG       RUSSELL    MCCORMICK  PRESTON    JOANNA     KRYSTAL    
TERENCE    : FOX        ROXANNE    PEREZ      RICKY      PHOEBE     INGRID     WENDI      
SANTANA    : ALEXANDER  JOY        STARK      GRETA      MURIEL     ADKINS     DWIGHT     MARYANNE   
SANTANA    : HORN       CONTRERAS  
ROMAN      : MOODY      AMADO      
KENDRA     : GIOVANNI   CINDY      STANLEY    
PETERSON   : JOANNA     CARISSA    ZAMORA     VICTOR     DENNIS     MCKEE      MITCHELL   
ROD        : MARCUS     KOCH       CHARLENE   
BASIL      : EVANGELINA CORNELIUS  
RICK       : SOTO       COLON      LANDON     CANTU      
MICHAEL    : EDMUND     SCOTTIE    CHERRY     
BATTLE     : SOSA       RYAN       WONG       
COTTON     : CANTRELL   NIELSEN    
BERNARDO   : KNOWLES    MILES      
WASHINGTON : KNOX       MERCER     SIMONE     MILDRED    BONNER     
JILLIAN    : ANITA      LAMBERT    
TERRENCE   : SHAWN      LORIE      DECKER     ROY        ROSA       
HERRING    : BETHANY    JOHNSTON   
FREDERICK  : HUGHES     REYNOLDS   
DYLAN      : CHANEY     FREDRIC    TERRI      
SIMPSON    : ENGLAND    
BRADFORD   : COLON      ALFREDA    FIELDS     INGRAM     
ERIK       : LORENZO    MARIA      HENSON     
CALVIN     : BORIS      DELANEY    CONSUELO   ODONNELL   
MARIANO    : VICTORIA   CONTRERAS  SCHROEDER  WONG       BRIGGS     
BARR       : LORIE      JANETTE    SHANNON    LAWSON     
ORTIZ      : HORTON     MCKEE      WILL       SCHULTZ    JULIAN     
DON        : COOKE      CHAVEZ     CHARITY    RICKY      
THADDEUS   : ROSA       NORMA      LANG       FRANCISCO  
SCHWARTZ   : MARGARITO  
AYALA      : ROSALIE    OSCAR      BUDDY      GERARDO    CALLAHAN   DAMIAN     ROSETTA    
HUDSON     : TORRES     LOWE       LUISA      SHELLEY    
TRUDY      : DOYLE      TRAN       NIEVES     BUCKNER    MAXINE     ANASTASIA  
ARTHUR     : VELMA      WALTER     STEWART    BARLOW     SNOW       TYLER      HAWKINS    MONROE     
ARTHUR     : BRIGGS     
COFFEY     : DIAZ       DONA       REYNA      BOB        CORRINE    
MAYER      : DELMAR     KASEY      ANNABELLE  
NADINE     : MILAGROS   LENORA     MORENO     REINALDO   HOLLAND    
DUNCAN     : WEISS      ANITA      FORBES     HAYS       MCKEE      ALBERTO    
REGGIE     : ANDY       DENIS      BRIDGETTE  CARR       TYLER      
BLAIR      : BUCKNER    MCKENZIE   BALLARD    PERRY      RAMIRO     COLLINS    KELLY      
SHERMAN    : HOOPER     EMORY      PATRICK    
LENORA     : NADINE     MUNOZ      CLEMONS    HUNT       
CHUCK      : SHERYL     STACI      ROYCE      
GATES      : ROB        SHERYL     MILES      DAVENPORT  JOSH       
SOFIA      : LORRAINE   ESMERALDA  JULIE      HOLDER     MCCORMICK  WONG       
FERDINAND  : HEBERT     KATHLEEN   GRAHAM     NGUYEN     
ISIDRO     : VERN       DARNELL    YVETTE     
KELLER     : JEFFERSON  HIGGINS    LEVINE     MEREDITH   
CANDY      : PENNINGTON 
JAY        : ANNIE      ERNESTINE  BRENTON    
TURNER     : JANETTE    JULIET     COTE       
MUNOZ      : LENORA     MINNIE     
VARGAS     : CANTRELL   ESTEBAN    CRYSTAL    
WENDI      : CRISTINA   TERENCE    SUAREZ     CASSIE     
RANDALL    : LOTTIE     MERRITT    
JOAN       : TINA       JAMAR      LAUREN     THURMAN    
ERNA       : COPELAND   ABRAHAM    STEPHENS   GUZMAN     JARVIS     DEMETRIUS  LESSIE     
VANCE      : VILMA      REBEKAH    ELIZA      BRAY       
AMADO      : LYMAN      TRACEY     MOHAMED    ROMAN      
CARVER     : MCMILLAN   
LACEY      : THOMPSON   MARYELLEN  DELANEY    WARREN     
INA        : NANETTE    LORENA     RAUL       
HARRIET    : RONALD     MARVIN     
AISHA      : ANDERSON   WALL       
ALI        : NEAL       RODRIQUEZ  DIXIE      WELDON     
FORREST    : LUCAS      QUINN      RONALD     
ADDIE      : MCLEOD     ELBERT     KEITH      
GALLAGHER  : PECK       HOLDER     NEIL       DONOVAN    LETICIA    DANIELS    
KNIGHT     : VILMA      CONNIE     CLYDE      FOWLER     CASEY      
KRISTINE   : DECKER     WHITNEY    ONEIL      
ROBERT     : ADAM       DONNY      
CLARENCE   : WILLARD    HENSON     ED         KNOWLES    
WHITE      : GLENN      GUY        LORI       ROB        NOE        BOBBIE     
KERRI      : FRYE       JOYCE      DANA       
HOFFMAN    : MILAGROS   ELVIRA     KRISTEN    GILMORE    PETTY      INGRID     
TABITHA    : MAVIS      LEWIS      MAYS       LINDSAY    AGNES      BUDDY      SHEPHERD   
DURAN      : PERCY      CARSON     MCMAHON    
CORNELIUS  : PEARSON    SLOAN      HODGE      BASIL      KANE       
HOWELL     : JACLYN     JANINE     RUSSELL    POTTS      RUTLEDGE   ASHLEY     
CHARMAINE  : ABE        HERMAN     BAIRD      RUSSO      
ERNIE      : BELL       ABEL       SALAZAR    EDMUND     LETICIA    
MARSHALL   : JIM        LATONYA    SCHNEIDER  MOLLIE     
HOOD       : JARVIS     NEAL       NIEVES     STEVENSON  
HARRIS     : ROSARIO    GUY        GALLOWAY   BAUER      
FRANKIE    : ANTONE     FLETCHER   CAROLINE   CARROLL    
LAWSON     : MCMILLAN   BARR       MADDEN     ROWE       
DEWITT     : HECTOR     SYKES      
LEON       : DOYLE      
SANCHEZ    : MARIBEL    LORENZO    EUGENIA    FRY        SHANA      
GONZALES   : DORIS      HARRELL    COOLEY     STEWART    LEROY      
JEANNE     : ELMA       MARCELO    LITTLE     WOLF       JEAN       
LIDIA      : FRANKS     IRIS       
CUMMINGS   : ED         BARLOW     PITTMAN    
HAWKINS    : ERICKSON   WALTER     ARTHUR     
LE         : SUSAN      VERNON     EARLE      JOANNA     WALTER     ESTRADA    
ANASTASIA  : JOSE       TRUDY      GILBERTO   
ROYCE      : ANTONE     CHUCK      TRENT      
BURKS      : URSULA     PHILLIPS   TYREE      BRANDI     EARNEST    MERCEDES   ALVIN      COTE       
BURKS      : 
FLYNN      : WALTER     
DALTON     : WOLF       LOGAN      HARPER     
STRONG     : VALERIE    KURT       HARRELL    
CLINT      : WEBSTER    LUNA       EMILE      COLLEEN    MCCARTY    
LORNA      : AVIS       LEVI       SYDNEY     MOODY      
ENID       : STEVENS    VALENCIA   MCNEIL     TAMMI      REESE      
JACKSON    : RAPHAEL    FRYE       
RICHARDSON : THOMPSON   MARION     JEAN       ARNULFO    
BRYANT     : ROCCO      GARNER     GIBSON     JANICE     LYNN       
CLEMONS    : BURTON     CAROLYN    LENORA     MCKAY      EUGENIA    
CHARLENE   : KERI       FULLER     WILL       ROD        
ROWE       : JEREMY     KARLA      DEANNE     GONZALEZ   LAWSON     
REINALDO   : CHANDLER   NADINE     
JOHNNIE    : LEONARDO   BRADSHAW   LARSON     AGNES      JARROD     
TANYA      : LANGLEY    CAMERON    DAREN      
COTE       : WARREN     MCKENZIE   DONNY      TURNER     BURKS      BOWERS     HUNT       
POOLE      : BREWER     MCGOWAN    
ONEIL      : KRISTINE   PHOEBE     RUSSELL    CALDWELL   LORAINE    
HELENA     : HOLDER     TORRES     ESTEBAN    OTTO       MCBRIDE    
HUBBARD    : BEST       BEAN       PETTY      
MARCEL     : ADELINE    ENGLISH    ALFRED     HOGAN      
BRAY       : JERALD     TAMERA     ROBLES     VANCE      
DAMON      : FEDERICO   HOMER      ODELL      
AIDA       : IRVIN      BLAKE      
BLAKE      : MAXWELL    BEAN       WOLFE      MILLS      AIDA       ROB        
GEORGIA    : CRYSTAL    RACHAEL    
NELDA      : WILL       
GRAHAM     : FERDINAND  KIP        
HOWARD     : WARNER     
STEVENSON  : MARCELINO  ALLISON    LORI       NOELLE     JANINE     GLASS      HOOD       
STACY      : HARRELL    SIMS       COOLEY     HODGE      
CAROL      : VELMA      PATRICK    CASTRO     
MADDEN     : LAWSON     LYDIA      MILLICENT  MARY       
ROSALES    : GRETA      ALEXANDER  ISABELLA   
ALISSA     : ROB        DILLON     CHERI      FOSTER     LLOYD      
RODERICK   : VICTOR     NEWTON     GARZA      MONROE     PALMER     
NOEL       : REBEKAH    
MCLEAN     : ROBBY      ROMERO     
CONSUELO   : MAVIS      FRANCESCA  GALEN      SALINAS    HUMBERTO   CALVIN     
CARLA      : BUTLER     MERLE      ANNA       MAE        SONNY      
KASEY      : WOLFE      VINCENT    SCHROEDER  MAYER      BARTLETT   BRADSHAW   ALBERTO    
MORENO     : MERLE      NADINE     KATHARINE  CHANDLER   LEVINE     
BARNETT    : BENITO     BONITA     
ANDREW     : CANDICE    CARMINE    SALVATORE  
SAVANNAH   : CORY       LYNN       JAMEL      
DUNLAP     : BORIS      BOWERS     STEFANIE   LEROY      
MITCHELL   : QUINCY     ALFRED     PATSY      PETERSON   
HEWITT     : SANTIAGO   NANETTE    CALLAHAN   TIMOTHY    WALL       
BARBRA     : MARTINEZ   NOEMI      SHANNON    JOSEPH     ERICKSON   
JOSH       : GATES      DORA       
MILO       : DORIS      MICAH      MABEL      BRANDI     JANICE     PHELPS     
MACK       : ALBERTO    CHRISTI    BUCKNER    GLORIA     
ODONNELL   : IGNACIO    PITTMAN    TUCKER     CALVIN     GIBBS      
JOHNSON    : LAUREL     ERMA       JIM        HOUSTON    BETH       
MINNIE     : STOUT      MUNOZ      DARCY      VALENZUELA 
CASTRO     : VINCENT    CAROL      TREY       SONYA      RYAN       
JAMEL      : ANNA       ADKINS     SAVANNAH   ANGIE      
HOLLOWAY   : ROBERTA    PARRISH    VALENZUELA RUSSO      
LANG       : FOREMAN    GREGORY    THADDEUS   DANIAL     
SALVATORE  : ANDREW     ALLISON    MARTHA     
RANDOLPH   : HORN       TREVINO    LESLIE     LUCAS      
TRAVIS     : ELIJAH     PALMER     
DEVON      : TOBY       LAMBERT    THURMAN    SOSA       
FRANCISCO  : CLEMENTS   DARYL      WOODWARD   THADDEUS   
CORRINE    : PERRY      KATY       KENNEDY    CAIN       JULIET     COFFEY     CONSTANCE  
HOGAN      : MARCEL     LOURDES    
DANIEL     : CAROLYN    NOEMI      
ANGELITA   : SIMON      AURORA     SHEPHERD   ELOISE     ALBERTO    
MARISSA    : ERIN       TARA       MONROE     BRYAN      
OBRIEN     : WALTON     SYDNEY     KRISTOPHER RUTLEDGE   RAMSEY     THURMAN    DELORIS    
WINFRED    : BELL       ANNMARIE   JESSE      SCHNEIDER  FEDERICO   DAVID      
CLAUDIA    : JANICE     GOOD       ANDY       CHARLOTTE  RASMUSSEN  
GIBBS      : RICARDO    MICHEAL    ODONNELL   
FERRELL    : MONTGOMERY TODD       ORR        EARNEST    WILLARD    GINGER     ESTRADA    
ELINOR     : JILL       FERN       MABEL      
LUCY       : JULIA      TAMMIE     ESTEBAN    
GAY        : HOLLIE     FERNANDEZ  CLEMENTS   GARZA      SCHROEDER  
MOSLEY     : OCONNOR    JACOB      HOMER      MARTIN     
FUENTES    : BRENDAN    CURRY      
JULIAN     : ORTIZ      TOBY       MARVIN     
PASQUALE   : ODELL      FARLEY     PRUITT     CHANCE     AVIS       
LEROY      : POPE       GONZALES   MCCONNELL  MCINTYRE   DUNLAP     
DELBERT    : LAWANDA    
DANIAL     : PITTMAN    NIKKI      YANG       GUZMAN     LANG       
PHELPS     : WILFREDO   KATHY      MILO       
MAYNARD    : MARTINEZ   NOLAN      BRIDGETTE  
JOYNER     : LANDON     ISIAH      ENGLAND    
CURTIS     : BARTLETT   FEDERICO   MERRITT    HUMBERTO   TY         
CONSTANCE  : SAUNDERS   ROSALINDA  CORRINE    CHANEY     OLSON      
TANNER     : MOLLIE     NOE        TINA       ALEXANDRA  HOLMAN     PECK       BRYAN      
KRAMER     : MCNEIL     ANIBAL     DOROTHEA   SUSAN      BRUCE      REYNOLDS   
MCGOWAN    : ISRAEL     WALL       POOLE      
SELLERS    : ELIZA      TAMMY      PUGH       CHRISTA    JOHNSTON   
SHELLEY    : CORY       BRIDGETTE  HUDSON     DELACRUZ   DUKE       LEONARD    
ALFONSO    : TABATHA    TERRI      
CROSBY     : HATFIELD   KOCH       LEVINE     ROJAS      MOLINA     FOSTER     
PARSONS    : GARTH      ELOISE     ALTON      VICTORIA   COX        
HELGA      : GUZMAN     
ALINE      : KIM        ELDON      
GALLOWAY   : HANSON     PRISCILLA  ADAMS      HARRIS     REEVES     MARGUERITE MEADOWS    
LINDSEY    : SOLOMON    JENNINGS   BLACKWELL  LENORE     
JOSEPHINE  : JAIME      PETER      BRIDGETTE  PATSY      
BERNADINE  : BRENDAN    LUPE       
OWEN       : HINTON     CHERI      CONTRERAS  
CASEY      : NICHOLS    DONNA      KNIGHT     LETITIA    HOLCOMB    
TYLER      : ARTHUR     FRYE       REGGIE     
MARCIA     : FLORES     DUSTY      NEWTON     ELDON      BERTIE     BOWERS     GOODWIN    RUSSEL     
MARCIA     : 
COLLINS    : BLAIR      KENDALL    MURIEL     
MONROE     : IRIS       SHAWN      DELORIS    RODERICK   MARISSA    JOHANNA    SALINAS    ARTHUR     
MONROE     : 
MARVIN     : ANTONE     LYMAN      HARRIET    JULIAN     
DUFFY      : ELIZA      FOSTER     
JOHNSTON   : FOREST     BUCK       REFUGIO    HERRING    SELLERS    MCLAUGHLIN KERI       
KELLY      : ENGLISH    BLAIR      
RUSSO      : JIMMIE     PEREZ      HOLLOWAY   LEE        AMANDA     CHARMAINE  MERRILL    
BRIDGET    : VERA       BARTON     
LYNN       : BRYANT     SAVANNAH   AHMED      DELORIS    HILL       
BEASLEY    : LACY       ISABELLA   RICO       SONYA      JEWELL     
ETHEL      : KERI       SYBIL      OTTO       MILES      LARSON     
MACIAS     : PIERCE     EDWIN      
FINLEY     : GOMEZ      BROCK      HANEY      DENA       BUDDY      BETH       
BARTON     : LANGLEY    GILMORE    SCHULTZ    BRIDGET    
RUSSEL     : ESTES      KIM        ROBBINS    MARCIA     TY         
PALMER     : RODERICK   TRAVIS     STOUT      ROXANNE    
GLOVER     : CRAFT      ENRIQUE    VONDA      
LAWANDA    : MUELLER    DELBERT    OLIVER     BORIS      DAREN      ALBERT     
EVE        : LESTER     GONZALEZ   LYDIA      BETHANY    ALICIA     ROSEMARY   NEIL       
GILBERTO   : LATISHA    ANASTASIA  
LLOYD      : DODSON     HINES      ETTA       ALISSA     
HEAD       : PHOEBE     DONOVAN    GARZA      BENTLEY    
PARKS      : RONNY      ANNA       HAMILTON   
MARTIN     : ROSE       XAVIER     COMPTON    MOSLEY     
SAVAGE     : KLINE      JANINE     AURORA     BUCKLEY    
MAURICE    : LUISA      HULL       ROBIN      
STEPHENSON : GLADYS     PERRY      GILL       
NICHOLSON  : ANNA       FOREMAN    JACOBS     WATERS     
BRIGGS     : DALE       SYBIL      MARIANO    ARTHUR     
REYNOLDS   : JANINE     HECTOR     MATHIS     FREDERICK  KRAMER     SEARS      MARIANA    NATASHA    
REYNOLDS   : LOGAN      
REILLY     : PHILLIPS   
EVANGELINE : PATE       CECIL      ANTONIA    COMPTON    REEVES     CARMELO    CATHRYN    
BRYAN      : BENNIE     BONITA     REUBEN     LANCASTER  MARISSA    BRIAN      JAMAR      TANNER     
BRYAN      : 
NGUYEN     : LON        FERDINAND  
WEBB       : MIKE       DUKE       DEJESUS    ISABELLA   
ROTH       : ELISEO     LES        FLORINE    FEDERICO   ROBIN      MCMAHON    
KANE       : KENT       CORNELIUS  RICE       PAYNE      
ALBERT     : HANSON     MILAGROS   ALTA       LAWANDA    
LESSIE     : ERNA       PITTMAN    BENTLEY    CHRISTIAN  
ANGIE      : ELMA       JAMEL      WHITLEY    GARNER     
DEAN       : TERRY      WILKINSON  ELVA       CLEMENTS   CALLAHAN   MCCLURE    
MCCLURE    : FREDERIC   SCHROEDER  DEAN       DUSTY      
STANLEY    : HENDRICKS  KENDRA     SUZETTE    WATTS      
MCBRIDE    : HELENA     LORRAINE   
HUNT       : JENNINGS   MILAGROS   WALDO      MCCRAY     COTE       RAYMOND    LENORA     
BETH       : AHMED      FINLEY     NUNEZ      BEACH      JOHNSON    
RENA       : PICKETT    SHIRLEY    MILLS      SARGENT    WHITLEY    JANETTE    
ROBERTSON  : CONNIE     AURELIA    HERIBERTO  SHANA      JAYNE      ALBERTO    
KEVIN      : SCHNEIDER  
KRYSTAL    : MCINTYRE   JEWELL     GRAY       HUFFMAN    DIAZ       JESSIE     ROSEMARY   HARPER     
KRYSTAL    : 
WELDON     : HAZEL      HENRY      ALI        
ESTRADA    : JORDAN     HERIBERTO  BUCHANAN   FERRELL    LE         RAUL       
GREENE     : QUINN      HIRAM      MOISES     
MCMAHON    : HART       ROTH       COOK       BENTON     DURAN      
TRENT      : YANG       STEVENS    GIBSON     ROYCE      
REGINA     : LEONEL     
POLLARD    : VALERIE    DEJESUS    FRY        MCINTYRE   PAT        GRIFFIN    GIBSON     
QUINTON    : MEREDITH   FERN       LAURI      
CAROLE     : GABRIELA   
HOLLAND    : OSCAR      ROY        FOWLER     NADINE     
KERR       : LEACH      MARKS      INGRAM     REFUGIO    COPELAND   ERIKA      
DARRYL     : VERA       MARGERY    BILLIE     ARIEL      BOYLE      
CHARLES    : ANNIE      WISE       MARIE      BERTIE     JULIO      
LOGAN      : GILMORE    PORTER     DALTON     REYNOLDS   
CASSIE     : IVANA      BALDWIN    WENDI      
BOWEN      : MCKENZIE   
HARPER     : BYRD       DALTON     CARNEY     ROBIN      KRYSTAL    
FRANKLIN   : ROBBIE     JERALD     STACIE     DIXON      
WONG       : WEAVER     HENDRICKS  TORRES     MARIANO    SOFIA      DEANDRE    KRISTOPHER BATTLE     
WONG       : 
MERRILL    : EMORY      CARLO      RUSSO      
MONA       : LUCIEN     HOLDEN     ANDREA     KEITH      
TONIA      : JEAN       SILVA      
DANA       : GERARDO    ROSA       KERRI      PERRY      MCCORMICK  
ANNABELLE  : FRIEDA     ED         PHILLIP    LARSEN     SOLOMON    MAYER      
TY         : DARCY      SHARON     NIELSEN    CURTIS     RUSSEL     NICHOLS    BARBER     
HILL       : DEANNE     HATFIELD   RICE       LYNN       
BAUER      : SANFORD    HARRIS     JACLYN     
TRACY      : MARYANNE   HURST      BENITO     SYKES      SOSA       
HAYDEN     : TOBY       PETER      ROB        RICHMOND   LIZZIE     
NATASHA    : THOMAS     ALFONZO    REYNOLDS   MALLORY    
RAUL       : BOWMAN     ESTRADA    FIGUEROA   HURLEY     INA        
VAUGHN     : KELLEY     WALLER     
LORAINE    : JACOB      RAYMOND    NIELSEN    EDWIN      ONEIL      
RACHAEL    : CHANDLER   GEORGIA    HERRERA    ELISEO     
SHERRI     : CONNER     
PETERSEN   : MADELINE   CHAVEZ     KENTON     
